//MAP CONVERTED BY dmm2tgm.py THIS HEADER COMMENT PREVENTS RECONVERSION, DO NOT REMOVE
"av" = (
/mob/living/simple_animal/hostile/feed/chocolate_slime,
/turf/open/floor/iron/checker,
/area/ruin/space/has_grav)
"aL" = (
/obj/effect/turf_decal/tile/dark/opposingcorners,
/obj/effect/turf_decal/tile/neutral/opposingcorners{
	dir = 1
	},
/obj/structure/wall_torch/spawns_lit/directional/east,
/turf/open/floor/sepia,
/area/ruin/space/has_grav)
"bR" = (
/turf/closed/indestructible/dungeon/corner{
	dir = 1
	},
/area/ruin/space/has_grav)
"dn" = (
/turf/open/floor/iron/checker,
/area/ruin/space/has_grav)
"dy" = (
/turf/closed/indestructible/candy,
/area/ruin/space/has_grav)
"dF" = (
/obj/structure/table/reinforced/titaniumglass,
/obj/effect/spawner/random/food_or_drink/dinner,
/turf/open/floor/iron/colony,
/area/ruin/space/has_grav)
"fa" = (
/obj/structure/trap/fattening,
/turf/open/floor/iron/checker,
/area/ruin/space/has_grav)
"fQ" = (
/obj/structure/table/reinforced/titaniumglass,
/obj/effect/spawner/random/food_or_drink/three_course_meal,
/obj/item/slime_cookie/calorite,
/obj/structure/wall_torch/spawns_lit/directional/west,
/turf/open/floor/iron/colony,
/area/ruin/space/has_grav)
"gK" = (
/obj/effect/turf_decal/tile/dark/opposingcorners,
/obj/effect/turf_decal/tile/neutral/opposingcorners{
	dir = 1
	},
/obj/structure/wall_torch/spawns_lit/directional/south,
/turf/open/floor/sepia,
/area/ruin/space/has_grav)
"hE" = (
/obj/structure/wall_torch/spawns_lit/directional/north,
/turf/open/floor/carpet/orange,
/area/ruin/space/has_grav)
"iO" = (
/obj/effect/turf_decal/tile/dark/opposingcorners,
/mob/living/simple_animal/hostile/feed/chocolate_slime/creambeast,
/turf/open/floor/mineral/calorite/hide,
/area/ruin/space/has_grav)
"iY" = (
/obj/structure/table/reinforced/titaniumglass,
/obj/effect/spawner/random/food_or_drink/pizzaparty,
/obj/item/slime_cookie/calorite,
/turf/open/floor/iron/colony,
/area/ruin/space/has_grav)
"jj" = (
/obj/effect/turf_decal/tile/dark/opposingcorners,
/obj/structure/trap/belch,
/turf/open/floor/mineral/calorite/hide,
/area/ruin/space/has_grav)
"jn" = (
/obj/effect/turf_decal/tile/dark/opposingcorners,
/obj/effect/turf_decal/tile/neutral/opposingcorners{
	dir = 1
	},
/mob/living/simple_animal/hostile/feed/chocolate_slime/creambeast,
/turf/open/floor/sepia,
/area/ruin/space/has_grav)
"jI" = (
/turf/closed/mineral/asteroid/has_air,
/area/ruin/space/has_grav)
"kq" = (
/obj/structure/wall_torch/spawns_lit/directional/north,
/turf/open/floor/iron/checker,
/area/ruin/space/has_grav)
"kr" = (
/obj/machinery/field/generator/anchored,
/turf/open/floor/plating,
/area/ruin/space/has_grav)
"kv" = (
/obj/structure/table/reinforced/titaniumglass,
/obj/item/slime_cookie/calorite,
/obj/structure/wall_torch/spawns_lit/directional/west,
/obj/effect/spawner/random/food_or_drink/dinner,
/turf/open/floor/iron/colony,
/area/ruin/space/has_grav)
"kH" = (
/obj/structure/fans/tiny/forcefield,
/turf/open/misc/asteroid/airless,
/area/ruin/space/has_grav)
"kX" = (
/obj/structure/table/reinforced/titaniumglass,
/obj/effect/spawner/random/food_or_drink/pizzaparty,
/turf/open/floor/iron/colony,
/area/ruin/space/has_grav)
"ll" = (
/obj/item/flashlight/lantern/on,
/turf/open/misc/asteroid,
/area/ruin/space/has_grav)
"lm" = (
/turf/closed/indestructible/dungeon{
	dir = 1
	},
/area/ruin/space/has_grav)
"ls" = (
/obj/structure/mineral_door/calorite,
/obj/effect/turf_decal/tile/dark/opposingcorners,
/obj/structure/trap/fattening,
/turf/open/floor/mineral/calorite/hide,
/area/ruin/space/has_grav)
"ly" = (
/obj/structure/table/reinforced/plastitaniumglass,
/obj/item/pizzabox/infinite{
	pixel_y = 10
	},
/turf/open/floor/carpet/orange,
/area/ruin/space/has_grav)
"mI" = (
/obj/effect/turf_decal/tile/dark/opposingcorners,
/obj/effect/turf_decal/tile/neutral/opposingcorners{
	dir = 1
	},
/turf/open/floor/sepia,
/area/ruin/space/has_grav)
"mM" = (
/obj/structure/fans/tiny/forcefield,
/turf/open/misc/asteroid,
/area/ruin/space/has_grav)
"mO" = (
/obj/item/flashlight/lantern/on,
/turf/open/floor/carpet/orange,
/area/ruin/space/has_grav)
"nE" = (
/turf/closed/wall/mineral/calorite,
/area/ruin/space/has_grav)
"oD" = (
/obj/structure/statue/calorite/fatty,
/obj/item/gavelhammer/loss{
	pixel_x = 15;
	pixel_y = 8
	},
/obj/structure/wall_torch/spawns_lit/directional/north,
/turf/open/floor/iron/colony,
/area/ruin/space/has_grav)
"oZ" = (
/obj/structure/statue/calorite/pillar,
/turf/open/floor/iron/colony/bolts,
/area/ruin/space/has_grav)
"qB" = (
/obj/effect/turf_decal/tile/dark/opposingcorners,
/obj/structure/table/reinforced/titaniumglass,
/obj/item/metal_food/mburger_calorite,
/turf/open/floor/mineral/calorite/hide,
/area/ruin/space/has_grav)
"qC" = (
/turf/template_noop,
/area/template_noop)
"qD" = (
/turf/open/floor/carpet/orange,
/area/ruin/space/has_grav)
"rv" = (
/turf/closed/indestructible/dungeon,
/area/ruin/space/has_grav)
"si" = (
/mob/living/simple_animal/hostile/feed/chocolate_slime/creambeast,
/turf/open/floor/iron/checker,
/area/ruin/space/has_grav)
"sz" = (
/obj/structure/fans/tiny/forcefield,
/turf/open/floor/plating,
/area/ruin/space/has_grav)
"sG" = (
/obj/structure/falsewall/calorite,
/turf/open/floor/iron/checker,
/area/ruin/space/has_grav)
"tv" = (
/obj/machinery/iv_drip/feeding_tube,
/turf/open/floor/iron/colony,
/area/ruin/space/has_grav)
"tR" = (
/obj/structure/table/reinforced/titaniumglass,
/obj/item/food/burger/greaseburger,
/turf/open/floor/iron/checker,
/area/ruin/space/has_grav)
"ub" = (
/obj/effect/turf_decal/tile/dark/opposingcorners,
/turf/open/floor/mineral/calorite/hide,
/area/ruin/space/has_grav)
"ug" = (
/obj/effect/spawner/random/entertainment/coin,
/turf/open/floor/iron/colony,
/area/ruin/space/has_grav)
"uO" = (
/obj/structure/table/reinforced/titaniumglass,
/obj/effect/spawner/random/food_or_drink/three_course_meal,
/turf/open/floor/iron/colony,
/area/ruin/space/has_grav)
"vw" = (
/obj/structure/wall_torch/spawns_lit/directional/west,
/turf/open/floor/iron/checker,
/area/ruin/space/has_grav)
"vM" = (
/turf/closed/indestructible/iron,
/area/ruin/space/has_grav)
"wo" = (
/turf/closed/indestructible/dungeon{
	dir = 4
	},
/area/ruin/space/has_grav)
"xX" = (
/turf/closed/indestructible/dungeon{
	dir = 8
	},
/area/ruin/space/has_grav)
"Ae" = (
/turf/closed/indestructible/chocolate,
/area/ruin/space/has_grav)
"AU" = (
/turf/open/misc/asteroid/airless,
/area/ruin/space/has_grav)
"DJ" = (
/obj/effect/mob_spawn/corpse/human/skeleton,
/turf/open/misc/asteroid,
/area/ruin/space/has_grav)
"EF" = (
/obj/structure/table/reinforced/titaniumglass,
/obj/item/food/cake/pound_cake,
/turf/open/floor/iron/checker,
/area/ruin/space/has_grav)
"EN" = (
/turf/closed/indestructible/dungeon/corner{
	dir = 4
	},
/area/ruin/space/has_grav)
"EY" = (
/obj/structure/table/reinforced/titaniumglass,
/obj/effect/spawner/random/entertainment/money_small,
/turf/open/floor/iron/checker,
/area/ruin/space/has_grav)
"Fj" = (
/obj/effect/turf_decal/tile/dark/opposingcorners,
/obj/structure/table/reinforced/titaniumglass,
/obj/item/stack/sheet/mineral/calorite/ten,
/obj/item/stack/sheet/mineral/calorite/ten,
/turf/open/floor/mineral/calorite/hide,
/area/ruin/space/has_grav)
"Gt" = (
/obj/structure/table/reinforced/titaniumglass,
/obj/item/flashlight/lantern/on,
/turf/open/floor/iron/colony,
/area/ruin/space/has_grav)
"GO" = (
/obj/structure/mineral_door/calorite,
/obj/effect/turf_decal/tile/dark/opposingcorners,
/obj/structure/wall_torch/spawns_lit/directional/south,
/obj/structure/trap/fattening,
/turf/open/floor/mineral/calorite/hide,
/area/ruin/space/has_grav)
"Ho" = (
/obj/structure/table/reinforced/plastitaniumglass,
/obj/item/reagent_containers/cup/beaker/galbanic{
	pixel_x = 8
	},
/obj/item/reagent_containers/cup/beaker/micro_calorite{
	pixel_x = -8
	},
/turf/open/floor/iron/colony,
/area/ruin/space/has_grav)
"Ik" = (
/obj/structure/table/reinforced/titaniumglass,
/obj/item/coin/bananium{
	pixel_x = -7
	},
/obj/item/coin/bananium,
/turf/open/floor/iron/checker,
/area/ruin/space/has_grav)
"Iu" = (
/obj/structure/mineral_door/dungeon,
/obj/structure/fans/tiny,
/turf/open/floor/mineral/calorite/hide,
/area/ruin/space/has_grav)
"JN" = (
/obj/structure/statue/calorite/fatty,
/obj/item/slime_cookie/calorite{
	pixel_x = -6;
	pixel_y = -8
	},
/turf/open/floor/mineral/calorite/dance,
/area/ruin/space/has_grav)
"Lh" = (
/turf/closed/indestructible/dungeon/corner,
/area/ruin/space/has_grav)
"Mc" = (
/turf/open/floor/iron/colony,
/area/ruin/space/has_grav)
"Nd" = (
/obj/effect/turf_decal/tile/dark/opposingcorners,
/obj/effect/turf_decal/tile/neutral/opposingcorners{
	dir = 1
	},
/obj/structure/table/reinforced/titaniumglass,
/obj/item/coin/runite,
/turf/open/floor/sepia,
/area/ruin/space/has_grav)
"NA" = (
/obj/structure/table/reinforced/titaniumglass,
/obj/effect/spawner/random/food_or_drink/dinner,
/turf/open/floor/iron/checker,
/area/ruin/space/has_grav)
"NM" = (
/obj/structure/sign/poster/official/calorite/directional/south,
/obj/item/clothing/suit/space,
/obj/item/clothing/head/helmet/space{
	pixel_x = 10;
	pixel_y = 10
	},
/turf/open/misc/asteroid,
/area/ruin/space/has_grav)
"OP" = (
/obj/structure/wall_torch/spawns_lit/directional/east,
/turf/open/floor/iron/checker,
/area/ruin/space/has_grav)
"OY" = (
/turf/closed/indestructible/dungeon/corner{
	dir = 8
	},
/area/ruin/space/has_grav)
"PD" = (
/obj/structure/table/reinforced/titaniumglass,
/obj/structure/wall_torch/spawns_lit/directional/south,
/obj/effect/spawner/random/food_or_drink/dinner,
/turf/open/floor/iron/colony,
/area/ruin/space/has_grav)
"PH" = (
/obj/structure/trap/belch,
/turf/open/floor/iron/checker,
/area/ruin/space/has_grav)
"QR" = (
/obj/structure/wall_torch/spawns_lit/directional/west,
/mob/living/simple_animal/hostile/feed/chocolate_slime/creambeast,
/turf/open/floor/iron/checker,
/area/ruin/space/has_grav)
"Rp" = (
/obj/structure/table/reinforced/titaniumglass,
/obj/effect/spawner/random/food_or_drink/pizzaparty,
/obj/structure/wall_torch/spawns_lit/directional/south,
/turf/open/floor/iron/colony,
/area/ruin/space/has_grav)
"Rv" = (
/obj/effect/turf_decal/tile/dark/opposingcorners,
/obj/structure/trap/fattening,
/turf/open/floor/mineral/calorite/hide,
/area/ruin/space/has_grav)
"Rz" = (
/obj/structure/sign/poster/official/calorite/directional/south,
/obj/item/clothing/glasses/meson,
/turf/open/misc/asteroid,
/area/ruin/space/has_grav)
"SJ" = (
/obj/structure/statue/calorite/fatty,
/obj/item/gavelhammer/permaloss{
	pixel_x = 15;
	pixel_y = 8
	},
/obj/structure/wall_torch/spawns_lit/directional/north,
/turf/open/floor/iron/colony,
/area/ruin/space/has_grav)
"TR" = (
/turf/open/misc/asteroid,
/area/ruin/space/has_grav)
"TS" = (
/obj/structure/table/reinforced/titaniumglass,
/obj/effect/spawner/random/food_or_drink/three_course_meal,
/turf/open/floor/iron/checker,
/area/ruin/space/has_grav)
"Vo" = (
/turf/closed/mineral/asteroid,
/area/ruin/space)
"VF" = (
/obj/structure/wall_torch/spawns_lit/directional/south,
/turf/open/floor/carpet/orange,
/area/ruin/space/has_grav)
"ZD" = (
/obj/effect/turf_decal/tile/dark/opposingcorners,
/mob/living/simple_animal/hostile/feed/chocolate_slime,
/turf/open/floor/mineral/calorite/hide,
/area/ruin/space/has_grav)

(1,1,1) = {"
qC
qC
qC
qC
qC
qC
qC
qC
qC
qC
qC
qC
qC
qC
qC
qC
qC
qC
qC
qC
qC
qC
qC
qC
qC
qC
qC
qC
qC
qC
qC
qC
qC
qC
qC
"}
(2,1,1) = {"
qC
qC
qC
qC
qC
qC
qC
qC
qC
qC
Vo
Vo
Vo
Vo
Vo
qC
Vo
Vo
Vo
Vo
Vo
Vo
Vo
Vo
Vo
Vo
Vo
Vo
Vo
qC
qC
qC
qC
qC
qC
"}
(3,1,1) = {"
qC
qC
qC
qC
qC
qC
Vo
Vo
Vo
Vo
Vo
Vo
Vo
Vo
Vo
Vo
Vo
Vo
Vo
Vo
Vo
Vo
Vo
Vo
Vo
Vo
Vo
Vo
Vo
Vo
Vo
Vo
Vo
Vo
qC
"}
(4,1,1) = {"
qC
qC
qC
qC
qC
Vo
Vo
Vo
Vo
Vo
Vo
Vo
Vo
Vo
Vo
Vo
Vo
Vo
Vo
Vo
Vo
Vo
Vo
Vo
Vo
Vo
Vo
Vo
Vo
Vo
Vo
Vo
Vo
Vo
Vo
"}
(5,1,1) = {"
qC
qC
qC
qC
Vo
Vo
Lh
wo
wo
wo
wo
wo
wo
wo
wo
wo
wo
wo
wo
wo
wo
wo
wo
wo
wo
wo
wo
wo
wo
wo
wo
EN
Vo
Vo
Vo
"}
(6,1,1) = {"
qC
qC
qC
qC
qC
Vo
rv
dn
Ae
PH
dn
QR
Ik
dy
dy
EY
dn
dn
vw
dn
fa
si
Ae
Ae
Ae
Ae
Ae
Ae
dy
Ae
Ae
lm
Vo
Vo
Vo
"}
(7,1,1) = {"
qC
qC
qC
qC
Vo
Vo
rv
fa
dy
dn
Ae
Ae
Ae
Ae
Ae
Ae
Ae
dn
Ae
Ae
dy
Ae
Ae
dy
fQ
iY
Gt
kv
iY
Ae
Ae
lm
Vo
Vo
qC
"}
(8,1,1) = {"
qC
qC
qC
Vo
Vo
Vo
rv
kq
Ae
dn
dn
dn
dn
dn
dn
dn
dn
dn
Ae
fa
dn
dn
Ae
kX
oZ
ug
ug
ug
oZ
dF
Ae
lm
Vo
Vo
qC
"}
(9,1,1) = {"
qC
qC
qC
Vo
Vo
Vo
rv
dn
dn
dn
Ae
Ae
Ae
dn
Ae
Ae
Ae
dy
Ae
Ae
Ae
dn
dy
SJ
ug
qD
qD
qD
ug
Rp
Ae
lm
Vo
Vo
Vo
"}
(10,1,1) = {"
qC
qC
qC
Vo
Vo
Vo
rv
dn
Ae
Ae
Ae
EF
Ae
dn
fa
dn
dn
Ae
dn
dn
dn
dn
dy
Ho
ug
qD
ly
qD
ug
dF
dy
lm
Vo
Vo
Vo
"}
(11,1,1) = {"
qC
qC
vM
vM
vM
Vo
rv
dn
dy
dn
dn
fa
Ae
Ae
Ae
Ae
dn
Ae
dn
Ae
Ae
dy
dy
oD
ug
qD
qD
qD
ug
PD
dy
lm
Vo
Vo
Vo
"}
(12,1,1) = {"
qC
qC
vM
kr
vM
vM
rv
dn
Ae
dn
Ae
dn
Ae
av
dn
PH
dn
Ae
dn
Ae
av
dn
Ae
kX
oZ
qD
qD
qD
oZ
uO
dy
lm
Vo
Vo
Vo
"}
(13,1,1) = {"
qC
qC
vM
sz
jI
jI
rv
dn
dn
dn
Ae
dn
Ae
dy
dy
dy
Ae
Ae
dn
Ae
Ae
dn
Ae
Ae
tv
qD
qD
qD
tv
Ae
Ae
lm
Vo
Vo
Vo
"}
(14,1,1) = {"
qC
qC
qC
kH
TR
jI
rv
Ae
dn
Ae
Ae
dn
dn
Ae
dn
dn
dn
dn
dn
Ae
dn
dn
nE
Ae
Ae
hE
qD
VF
dy
Ae
Fj
lm
Vo
Vo
Vo
"}
(15,1,1) = {"
qC
qC
AU
kH
DJ
TR
rv
kq
dn
dn
Ae
Ae
dn
Ae
dn
Ae
si
Ae
Ae
Ae
dn
nE
nE
Ae
oZ
qD
qD
qD
Ae
nE
GO
lm
Vo
Vo
Vo
"}
(16,1,1) = {"
qC
qC
AU
kH
TR
NM
rv
dn
Ae
dn
dn
Ae
dn
dn
fa
Ae
dn
dy
dn
dn
dn
dn
sG
PH
Mc
qD
qD
qD
Ae
nE
ls
lm
Vo
Vo
Vo
"}
(17,1,1) = {"
qC
qC
AU
kH
TR
TR
Iu
fa
dy
Ae
dn
Ae
Ae
Ae
Ae
Ae
PH
dy
dn
nE
nE
ub
nE
Ae
oZ
qD
mO
Ae
Ae
nE
ls
lm
Vo
Vo
Vo
"}
(18,1,1) = {"
qC
qC
qC
kH
ll
Rz
rv
Ae
Ae
dn
dn
dn
dn
dn
dn
dn
dn
Ae
dn
nE
ub
ub
nE
Ae
dy
dy
Ae
Ae
nE
nE
ls
lm
Vo
Vo
Vo
"}
(19,1,1) = {"
qC
qC
TR
mM
TR
TR
rv
kq
dn
dn
Ae
Ae
Ae
dy
Ae
Ae
Ae
Ae
dn
nE
Rv
nE
nE
nE
nE
nE
nE
nE
nE
nE
GO
lm
Vo
Vo
Vo
"}
(20,1,1) = {"
qC
qC
qC
kH
TR
jI
rv
Ae
dn
Ae
Ae
dn
dn
dn
dn
dn
dn
dn
dn
nE
ub
ub
nE
ub
ZD
ub
nE
ub
ZD
ub
ub
lm
Vo
Vo
qC
"}
(21,1,1) = {"
qC
qC
vM
sz
jI
jI
rv
dn
dn
Ae
si
dn
Ae
Ae
Ae
dy
Ae
Ae
Ae
nE
nE
iO
nE
Rv
nE
ub
nE
ub
nE
nE
ub
lm
Vo
Vo
Vo
"}
(22,1,1) = {"
qC
qC
vM
kr
vM
vM
rv
dn
nE
nE
nE
dn
dn
fa
dn
dn
dn
dn
dn
dn
nE
ub
nE
ub
nE
ub
iO
jj
nE
qB
ub
lm
Vo
Vo
Vo
"}
(23,1,1) = {"
qC
qC
vM
vM
vM
Vo
rv
dn
nE
JN
sG
dn
Ae
Ae
Ae
Ae
Ae
Ae
Ae
dn
nE
ub
ub
ub
nE
nE
nE
nE
nE
nE
nE
lm
Vo
Vo
Vo
"}
(24,1,1) = {"
qC
qC
Vo
Vo
Vo
Vo
rv
dn
nE
nE
nE
dn
Ae
dn
dn
dn
dn
PH
Ae
dn
nE
nE
nE
nE
nE
dn
dn
dn
Ae
dy
Ae
lm
Vo
Vo
Vo
"}
(25,1,1) = {"
qC
qC
qC
Vo
Vo
Vo
rv
dn
dn
dn
dn
dn
Ae
dn
Ae
dn
Ae
dn
Ae
dn
dn
dn
dn
dn
dn
dn
Ae
dn
dn
PH
si
lm
Vo
Vo
qC
"}
(26,1,1) = {"
qC
qC
qC
Vo
Vo
Vo
rv
dn
Ae
Ae
Ae
dn
dy
Ae
Ae
dn
dy
si
Ae
TS
Ae
dy
dy
Ae
Ae
Ae
Ae
Ae
Ae
Ae
mI
lm
Vo
Vo
qC
"}
(27,1,1) = {"
qC
qC
qC
Vo
Vo
Vo
rv
kq
dn
dn
Ae
dn
Ae
dn
fa
dn
Ae
dn
Ae
Ae
Ae
dy
mI
mI
mI
Ae
mI
mI
mI
Ae
gK
lm
Vo
Vo
qC
"}
(28,1,1) = {"
qC
qC
qC
Vo
Vo
Vo
rv
Ae
dy
dn
Ae
dn
Ae
dn
Ae
Ae
Ae
dn
Ae
tR
Ae
Ae
mI
Ae
jn
Ae
mI
Ae
mI
Ae
mI
lm
Vo
Vo
qC
"}
(29,1,1) = {"
qC
qC
qC
Vo
Vo
Vo
rv
NA
fa
av
Ae
OP
dn
dn
Ae
dn
dn
dn
OP
dn
Ae
Nd
mI
Ae
mI
aL
mI
Ae
mI
mI
mI
lm
Vo
Vo
qC
"}
(30,1,1) = {"
qC
qC
qC
qC
Vo
Vo
bR
xX
xX
xX
xX
xX
xX
xX
xX
xX
xX
xX
xX
xX
xX
xX
xX
xX
xX
xX
xX
xX
xX
xX
xX
OY
Vo
Vo
qC
"}
(31,1,1) = {"
qC
qC
qC
qC
Vo
Vo
Vo
Vo
Vo
Vo
Vo
Vo
Vo
Vo
Vo
Vo
Vo
Vo
Vo
Vo
Vo
Vo
Vo
Vo
Vo
Vo
Vo
Vo
Vo
Vo
Vo
Vo
Vo
Vo
qC
"}
(32,1,1) = {"
qC
qC
qC
qC
Vo
Vo
Vo
Vo
Vo
Vo
Vo
Vo
Vo
Vo
Vo
Vo
Vo
Vo
Vo
Vo
Vo
Vo
Vo
Vo
Vo
Vo
Vo
Vo
Vo
Vo
Vo
Vo
Vo
Vo
qC
"}
(33,1,1) = {"
qC
qC
qC
qC
qC
qC
qC
Vo
Vo
Vo
Vo
Vo
Vo
qC
qC
Vo
Vo
Vo
Vo
Vo
Vo
Vo
Vo
Vo
Vo
Vo
Vo
Vo
Vo
Vo
Vo
Vo
Vo
qC
qC
"}
(34,1,1) = {"
qC
qC
qC
qC
qC
qC
qC
qC
qC
qC
qC
qC
qC
qC
qC
qC
qC
qC
qC
qC
Vo
Vo
qC
qC
qC
qC
qC
qC
Vo
Vo
Vo
qC
qC
qC
qC
"}
