//MAP CONVERTED BY dmm2tgm.py THIS HEADER COMMENT PREVENTS RECONVERSION, DO NOT REMOVE
"au" = (
/obj/item/stack/ore/calorite,
/turf/open/misc/asteroid,
/area/ruin/space)
"bb" = (
/obj/item/stack/sheet/mineral/titanium,
/turf/open/floor/grass,
/area/ruin/space)
"bK" = (
/turf/closed/wall/mineral/calorite,
/area/ruin/space)
"cU" = (
/turf/open/misc/asteroid,
/area/ruin/space)
"cY" = (
/obj/structure/flora/rock/pile/jungle,
/turf/open/floor/grass,
/area/ruin/space)
"gj" = (
/obj/machinery/power/shuttle_engine/propulsion/right{
	dir = 8
	},
/turf/closed/wall/mineral/titanium,
/area/ruin/space)
"gl" = (
/obj/structure/dresser,
/turf/open/floor/wood,
/area/ruin/space)
"iw" = (
/obj/structure/reagent_crafting_bench,
/turf/open/floor/wood,
/area/ruin/space)
"iy" = (
/obj/structure/girder/displaced,
/obj/structure/lattice,
/turf/open/misc/asteroid,
/area/ruin/space)
"jg" = (
/turf/closed/mineral/asteroid,
/area/ruin/space)
"lm" = (
/obj/structure/reagent_anvil,
/obj/item/gavelhammer/fattening,
/turf/open/floor/wood,
/area/ruin/space)
"na" = (
/obj/structure/flora/tree/jungle/small/style_5,
/turf/open/floor/grass,
/area/ruin/space)
"nL" = (
/obj/structure/mineral_door/wood,
/turf/open/floor/wood,
/area/ruin/space)
"ob" = (
/obj/structure/flora/rock/pile/style_2,
/obj/structure/wall_torch/spawns_lit/directional/north,
/turf/open/misc/asteroid,
/area/ruin/space)
"px" = (
/turf/open/floor/wood,
/area/ruin/space)
"qw" = (
/obj/item/stack/ore/calorite,
/turf/closed/mineral/asteroid,
/area/ruin/space)
"ro" = (
/turf/open/misc/asteroid/airless,
/area/ruin/space)
"sC" = (
/obj/structure/flora/rock/pile/jungle/style_2,
/turf/open/floor/grass,
/area/ruin/space)
"ud" = (
/turf/closed/wall/mineral/wood,
/area/ruin/space)
"un" = (
/obj/structure/flora/bush/flowers_pp,
/obj/item/flashlight/lantern/on,
/turf/open/floor/grass,
/area/ruin/space)
"vl" = (
/obj/structure/flora/bush/flowers_br,
/turf/open/floor/grass,
/area/ruin/space)
"vL" = (
/obj/item/stack/ore/calorite,
/turf/open/floor/grass,
/area/ruin/space)
"xI" = (
/obj/item/stack/sheet/mineral/calorite/ten,
/turf/open/floor/mineral/calorite/dance,
/area/ruin/space)
"xU" = (
/obj/structure/closet/crate/grave/skeleton,
/turf/open/floor/grass,
/area/ruin/space)
"zk" = (
/obj/structure/bed/maint,
/turf/open/floor/wood,
/area/ruin/space)
"zp" = (
/turf/open/water/hot_spring,
/area/ruin/space)
"zx" = (
/obj/structure/table/wood,
/obj/item/clothing/suit/hooded/techpriest,
/turf/open/floor/wood,
/area/ruin/space)
"zI" = (
/obj/effect/mob_spawn/corpse/human/scientist,
/obj/effect/decal/cleanable/blood/trail_holder{
	dir = 8
	},
/turf/open/misc/asteroid,
/area/ruin/space)
"zQ" = (
/obj/item/shard/titanium,
/turf/open/misc/asteroid,
/area/ruin/space)
"Ap" = (
/obj/structure/flora/grass/jungle/a/style_2,
/turf/open/floor/grass,
/area/ruin/space)
"AA" = (
/obj/structure/girder/displaced,
/obj/structure/lattice,
/obj/item/stack/sheet/mineral/titanium,
/turf/open/misc/asteroid,
/area/ruin/space)
"AS" = (
/obj/item/stack/sheet/mineral/titanium,
/turf/open/misc/asteroid,
/area/ruin/space)
"Bu" = (
/obj/item/stack/ore/calorite,
/turf/open/misc/asteroid/airless,
/area/ruin/space)
"By" = (
/turf/template_noop,
/area/template_noop)
"CC" = (
/obj/structure/reagent_water_basin,
/turf/open/floor/wood,
/area/ruin/space)
"Fs" = (
/obj/structure/flora/bush/flowers_pp/style_3,
/turf/open/floor/grass,
/area/ruin/space)
"FI" = (
/obj/structure/flora/bush/flowers_pp,
/turf/open/floor/grass,
/area/ruin/space)
"GE" = (
/obj/structure/flora/tree/jungle/small/style_6,
/turf/open/floor/grass,
/area/ruin/space)
"GH" = (
/obj/structure/window/calorite/fulltile,
/turf/open/floor/plating,
/area/ruin/space)
"Ht" = (
/obj/structure/reagent_forge,
/turf/open/floor/wood,
/area/ruin/space)
"JC" = (
/turf/open/floor/grass,
/area/ruin/space)
"Ku" = (
/obj/structure/flora/rock/pile/style_3,
/obj/structure/wall_torch/spawns_lit/directional/west,
/turf/open/misc/asteroid,
/area/ruin/space)
"MN" = (
/obj/machinery/door/airlock/shuttle,
/turf/open/floor/mineral/titanium/tiled/blue/airless,
/area/ruin/space)
"Nd" = (
/obj/structure/mineral_door/calorite,
/turf/open/floor/wood,
/area/ruin/space)
"Nu" = (
/turf/closed/wall/mineral/titanium,
/area/ruin/space)
"NN" = (
/obj/structure/statue/calorite/fatty/huge,
/turf/open/floor/mineral/calorite/dance,
/area/ruin/space)
"OB" = (
/obj/structure/flora/rock,
/turf/open/misc/asteroid,
/area/ruin/space)
"OL" = (
/obj/structure/chair/comfy/shuttle{
	dir = 4
	},
/turf/open/floor/mineral/titanium/tiled/blue/airless,
/area/ruin/space)
"PC" = (
/obj/effect/decal/bigfatsigil,
/turf/open/misc/asteroid,
/area/ruin/space)
"Qk" = (
/obj/structure/flora/grass/jungle/a/style_5,
/turf/open/floor/grass,
/area/ruin/space)
"QT" = (
/obj/structure/grille/broken,
/obj/effect/decal/cleanable/blood/trail{
	dir = 8
	},
/turf/open/floor/mineral/titanium/tiled/blue/airless,
/area/ruin/space)
"Rn" = (
/obj/structure/chair/comfy/shuttle{
	dir = 4
	},
/obj/effect/decal/cleanable/blood/trail{
	dir = 8
	},
/turf/open/floor/mineral/titanium/tiled/blue/airless,
/area/ruin/space)
"Sg" = (
/obj/structure/wall_torch/spawns_lit/directional/north,
/turf/open/misc/asteroid,
/area/ruin/space)
"TZ" = (
/obj/structure/flora/tree/jungle/small/style_4,
/turf/open/floor/grass,
/area/ruin/space)
"Uw" = (
/turf/open/floor/mineral/calorite/dance,
/area/ruin/space)
"UP" = (
/obj/structure/flora/grass/jungle/a/style_4,
/turf/open/floor/grass,
/area/ruin/space)
"VP" = (
/obj/structure/wall_torch/spawns_lit/directional/west,
/turf/open/misc/asteroid,
/area/ruin/space)
"Ws" = (
/obj/item/stack/sheet/mineral/titanium,
/obj/structure/wall_torch/spawns_lit/directional/south,
/turf/open/floor/grass,
/area/ruin/space)
"WO" = (
/obj/structure/wall_torch/directional/north,
/turf/open/misc/asteroid,
/area/ruin/space)
"YS" = (
/obj/structure/statue/calorite/pillar,
/turf/open/floor/mineral/calorite/dance,
/area/ruin/space)
"ZL" = (
/turf/closed/wall/mineral/iron,
/area/ruin/space)

(1,1,1) = {"
By
By
By
By
By
By
By
By
By
By
By
By
By
By
By
By
By
By
By
By
"}
(2,1,1) = {"
By
By
By
By
By
jg
jg
jg
jg
By
By
By
By
ro
ro
By
By
By
By
By
"}
(3,1,1) = {"
By
By
By
By
jg
jg
jg
jg
ZL
By
By
By
ZL
ro
ro
ro
ro
ro
ro
By
"}
(4,1,1) = {"
By
By
By
jg
jg
jg
au
jg
ZL
gj
MN
gj
ZL
jg
Bu
jg
jg
jg
ro
ro
"}
(5,1,1) = {"
By
By
jg
jg
jg
ZL
Sg
cU
VP
Nu
OL
Nu
ZL
jg
jg
jg
jg
jg
jg
ro
"}
(6,1,1) = {"
By
jg
jg
jg
jg
OB
cU
PC
cU
iy
Rn
Nu
ZL
jg
ud
ud
ud
ZL
jg
jg
"}
(7,1,1) = {"
jg
qw
jg
jg
jg
jg
cU
cU
cU
AA
QT
iy
Ku
jg
ud
gl
zx
ud
jg
jg
"}
(8,1,1) = {"
jg
jg
jg
bK
bK
bK
bK
cU
cU
cU
zI
zQ
cU
cU
nL
px
zk
ud
jg
jg
"}
(9,1,1) = {"
jg
jg
bK
bK
CC
lm
GH
cU
cU
zQ
cU
cU
FI
Ws
ud
ud
ud
ZL
jg
jg
"}
(10,1,1) = {"
jg
jg
bK
YS
xI
px
bK
ob
cU
cU
cU
JC
TZ
Ap
ZL
jg
jg
jg
jg
jg
"}
(11,1,1) = {"
jg
jg
bK
NN
Uw
px
Nd
WO
AS
cU
JC
cY
UP
zp
zp
jg
jg
jg
jg
jg
"}
(12,1,1) = {"
jg
jg
bK
YS
xI
px
bK
Sg
cU
Qk
vl
bb
zp
zp
zp
zp
ZL
jg
jg
ro
"}
(13,1,1) = {"
jg
jg
bK
bK
iw
px
GH
cU
cU
vL
Ap
un
zp
zp
zp
jg
jg
jg
ro
By
"}
(14,1,1) = {"
By
jg
jg
bK
bK
Ht
bK
cU
sC
JC
JC
na
jg
ZL
jg
jg
jg
Bu
ro
By
"}
(15,1,1) = {"
By
jg
jg
jg
bK
bK
bK
na
xU
Fs
Qk
jg
jg
jg
jg
jg
ro
ro
By
By
"}
(16,1,1) = {"
By
By
jg
jg
jg
jg
jg
jg
JC
GE
jg
jg
jg
jg
jg
jg
By
By
By
By
"}
(17,1,1) = {"
By
By
By
jg
jg
jg
jg
jg
jg
jg
jg
jg
jg
jg
jg
ro
By
By
By
By
"}
(18,1,1) = {"
By
By
By
By
ro
Bu
jg
jg
jg
jg
jg
jg
jg
Bu
ro
By
By
By
By
By
"}
(19,1,1) = {"
By
By
By
By
By
ro
ro
jg
jg
jg
ro
ro
ro
By
By
By
By
By
By
By
"}
(20,1,1) = {"
By
By
By
By
By
By
By
By
By
By
By
By
By
By
By
By
By
By
By
By
"}
