//MAP CONVERTED BY dmm2tgm.py THIS HEADER COMMENT PREVENTS RECONVERSION, DO NOT REMOVE
"ap" = (
/obj/structure/table/wood,
/obj/item/reagent_containers/cup/glass/drinkingglass{
	pixel_x = -5;
	pixel_y = 2
	},
/obj/effect/turf_decal/siding/wood{
	dir = 1
	},
/turf/open/floor/carpet/green,
/area/ruin/space/has_grav/speedfucking)
"bx" = (
/obj/effect/turf_decal/siding/wood{
	dir = 5
	},
/obj/structure/chair/sofa/right{
	dir = 8;
	color = "4860E0"
	},
/turf/open/floor/carpet/royalblue,
/area/ruin/space/has_grav/speedfucking)
"bA" = (
/obj/machinery/vending/boozeomat,
/turf/open/floor/wood/large,
/area/ruin/space/has_grav/speedfucking)
"cF" = (
/obj/effect/turf_decal/arrows/white{
	dir = 1
	},
/turf/open/floor/iron/edge{
	dir = 4
	},
/area/ruin/space/has_grav/speedfucking)
"cU" = (
/obj/structure/table/wood,
/obj/effect/turf_decal/siding/wood,
/turf/open/floor/wood/large,
/area/ruin/space/has_grav/speedfucking)
"dx" = (
/obj/effect/turf_decal/arrows/white{
	dir = 1
	},
/obj/machinery/light/floor,
/turf/open/floor/iron/edge{
	dir = 4
	},
/area/ruin/space/has_grav/speedfucking)
"dF" = (
/obj/item/storage/box/matches{
	pixel_x = 6;
	pixel_y = -8
	},
/turf/open/floor/stone,
/area/ruin/space/has_grav/speedfucking)
"dI" = (
/obj/effect/turf_decal/siding/wood,
/obj/structure/chair/sofa/middle{
	dir = 1;
	color = "3B2161"
	},
/turf/open/floor/carpet/black,
/area/ruin/space/has_grav/speedfucking)
"ew" = (
/obj/structure/hedge,
/obj/structure/window/fulltile,
/obj/machinery/light/floor,
/turf/open/floor/plating,
/area/ruin/space/has_grav/speedfucking)
"eL" = (
/obj/effect/turf_decal/siding/wood,
/obj/structure/chair/sofa/corp{
	dir = 1
	},
/turf/open/floor/carpet/royalblack,
/area/ruin/space/has_grav/speedfucking)
"eP" = (
/obj/effect/turf_decal/siding/wideplating{
	dir = 8
	},
/obj/structure/chair/beanbag/red{
	dir = 8
	},
/obj/structure/sign/clock/directional/north,
/turf/open/floor/wood/parquet,
/area/ruin/space/has_grav/speedfucking)
"fe" = (
/obj/effect/turf_decal/siding/wood{
	dir = 10
	},
/obj/structure/chair/sofa/corner{
	dir = 1;
	color = "3B2161"
	},
/turf/open/floor/carpet/black,
/area/ruin/space/has_grav/speedfucking)
"ft" = (
/obj/structure/table/wood,
/obj/effect/turf_decal/siding/wood{
	dir = 6
	},
/obj/item/mop/advanced{
	pixel_x = 4;
	pixel_y = -1
	},
/obj/item/mop/advanced{
	pixel_x = -5;
	pixel_y = 0
	},
/obj/item/mop/advanced{
	pixel_x = -13;
	pixel_y = 1
	},
/turf/open/floor/wood/large,
/area/ruin/space/has_grav/speedfucking)
"fv" = (
/turf/open/floor/iron/edge,
/area/ruin/space/has_grav/speedfucking)
"fz" = (
/turf/open/floor/iron/edge{
	dir = 1
	},
/area/ruin/space/has_grav/speedfucking)
"fL" = (
/obj/structure/table/wood,
/obj/item/reagent_containers/cup/glass/bottle/wine{
	pixel_x = 16;
	pixel_y = 6
	},
/obj/item/reagent_containers/cup/glass/drinkingglass{
	pixel_x = 5;
	pixel_y = 2
	},
/obj/effect/turf_decal/siding/wood{
	dir = 1
	},
/turf/open/floor/carpet/purple,
/area/ruin/space/has_grav/speedfucking)
"fT" = (
/obj/effect/turf_decal/siding/wood/corner{
	dir = 4
	},
/obj/machinery/vending/donksnack,
/turf/open/floor/wood/large,
/area/ruin/space/has_grav/speedfucking)
"gD" = (
/obj/structure/table/wood,
/obj/item/reagent_containers/cup/glass/bottle/wine{
	pixel_x = 16;
	pixel_y = 6
	},
/obj/item/reagent_containers/cup/glass/drinkingglass{
	pixel_x = 5;
	pixel_y = 2
	},
/obj/effect/turf_decal/siding/wood{
	dir = 1
	},
/turf/open/floor/carpet/royalblue,
/area/ruin/space/has_grav/speedfucking)
"gH" = (
/obj/structure/lattice,
/turf/template_noop,
/area/ruin/space/has_grav/speedfucking)
"gU" = (
/turf/open/floor/iron/corner{
	dir = 4
	},
/area/ruin/space/has_grav/speedfucking)
"hj" = (
/obj/effect/turf_decal/arrows/white{
	dir = 4
	},
/turf/open/floor/iron/corner{
	dir = 8
	},
/area/ruin/space/has_grav/speedfucking)
"hk" = (
/obj/effect/turf_decal/arrows/white{
	dir = 1
	},
/turf/open/floor/iron/edge{
	dir = 8
	},
/area/ruin/space/has_grav/speedfucking)
"hI" = (
/obj/effect/turf_decal/siding/wideplating{
	dir = 4
	},
/obj/structure/chair/beanbag/red,
/obj/structure/sign/painting/parting{
	pixel_x = 0;
	pixel_y = 32
	},
/turf/open/floor/wood/parquet,
/area/ruin/space/has_grav/speedfucking)
"ib" = (
/obj/effect/turf_decal/siding/wood{
	dir = 4
	},
/turf/open/floor/wood/large,
/area/ruin/space/has_grav/speedfucking)
"ic" = (
/obj/machinery/vending/hotdog,
/turf/open/floor/wood/large,
/area/ruin/space/has_grav/speedfucking)
"if" = (
/obj/effect/turf_decal/siding/wood{
	dir = 6
	},
/obj/structure/chair/sofa/corner{
	dir = 8;
	color = "46802F"
	},
/turf/open/floor/carpet/green,
/area/ruin/space/has_grav/speedfucking)
"ii" = (
/obj/effect/turf_decal/siding/wood/corner,
/obj/machinery/vending/dorms,
/turf/open/floor/wood/large,
/area/ruin/space/has_grav/speedfucking)
"iT" = (
/obj/effect/spawner/structure/window/reinforced,
/obj/structure/curtain/cloth{
	color = "474747"
	},
/turf/open/floor/plating,
/area/ruin/space/has_grav/speedfucking)
"iX" = (
/obj/effect/turf_decal/siding/wideplating/corner{
	dir = 4
	},
/turf/open/floor/wood/parquet,
/area/ruin/space/has_grav/speedfucking)
"jf" = (
/turf/open/floor/wood/large,
/area/ruin/space/has_grav/speedfucking)
"jI" = (
/obj/effect/turf_decal/siding/wood,
/obj/structure/chair/sofa/middle{
	dir = 1;
	color = "922F9E"
	},
/turf/open/floor/carpet/purple,
/area/ruin/space/has_grav/speedfucking)
"jJ" = (
/obj/machinery/vending/cola/black,
/turf/open/floor/wood/large,
/area/ruin/space/has_grav/speedfucking)
"ke" = (
/turf/open/floor/iron/edge{
	dir = 4
	},
/area/ruin/space/has_grav/speedfucking)
"kr" = (
/obj/effect/turf_decal/siding/wideplating{
	dir = 4
	},
/obj/structure/sign/painting/parting{
	pixel_x = 0;
	pixel_y = 32
	},
/obj/structure/chair/beanbag/green,
/turf/open/floor/wood/parquet,
/area/ruin/space/has_grav/speedfucking)
"kM" = (
/obj/effect/turf_decal/siding/wood{
	dir = 9
	},
/obj/structure/chair/sofa/left/old{
	dir = 4;
	color = "4860E0"
	},
/turf/open/floor/carpet/royalblue,
/area/ruin/space/has_grav/speedfucking)
"ln" = (
/obj/effect/turf_decal/siding/wood{
	dir = 9
	},
/obj/structure/chair/sofa/left/old{
	dir = 4;
	color = "922F9E"
	},
/turf/open/floor/carpet/purple,
/area/ruin/space/has_grav/speedfucking)
"lE" = (
/turf/open/floor/iron/large,
/area/ruin/space/has_grav/speedfucking)
"mf" = (
/turf/open/floor/wood/parquet,
/area/ruin/space/has_grav/speedfucking)
"mn" = (
/obj/effect/spawner/structure/window/reinforced,
/obj/structure/curtain/cloth/fancy,
/turf/open/floor/plating,
/area/ruin/space/has_grav/speedfucking)
"mE" = (
/obj/structure/table/wood,
/obj/item/reagent_containers/cup/glass/drinkingglass{
	pixel_x = -5;
	pixel_y = 2
	},
/obj/effect/turf_decal/siding/wood{
	dir = 1
	},
/turf/open/floor/carpet/royalblack,
/area/ruin/space/has_grav/speedfucking)
"mZ" = (
/obj/effect/turf_decal/siding/wideplating{
	dir = 8
	},
/obj/structure/sign/clock/directional/north,
/obj/structure/chair/beanbag/black{
	dir = 8
	},
/turf/open/floor/wood/parquet,
/area/ruin/space/has_grav/speedfucking)
"ng" = (
/obj/effect/turf_decal/siding/wideplating{
	dir = 4
	},
/obj/structure/sign/painting/parting{
	pixel_x = 0;
	pixel_y = 32
	},
/obj/structure/chair/beanbag/blue,
/turf/open/floor/wood/parquet,
/area/ruin/space/has_grav/speedfucking)
"of" = (
/obj/machinery/quantumpad{
	map_pad_id = "speed_fucking"
	},
/obj/effect/turf_decal/bot,
/turf/open/floor/iron/large,
/area/ruin/space/has_grav/speedfucking)
"or" = (
/obj/effect/turf_decal/siding/wood{
	dir = 6
	},
/obj/structure/chair/sofa/corp/corner{
	dir = 8
	},
/turf/open/floor/carpet/royalblack,
/area/ruin/space/has_grav/speedfucking)
"pa" = (
/obj/effect/spawner/structure/window/reinforced,
/obj/structure/curtain/cloth{
	color = "4860E0"
	},
/turf/open/floor/plating,
/area/ruin/space/has_grav/speedfucking)
"pn" = (
/obj/effect/turf_decal/siding/wood{
	dir = 5
	},
/obj/structure/chair/sofa/right{
	dir = 8;
	color = "46802F"
	},
/turf/open/floor/carpet/green,
/area/ruin/space/has_grav/speedfucking)
"pI" = (
/obj/effect/turf_decal/siding/wideplating{
	dir = 4
	},
/obj/structure/sign/painting/parting{
	pixel_x = 0;
	pixel_y = 32
	},
/obj/structure/chair/beanbag/black,
/turf/open/floor/wood/parquet,
/area/ruin/space/has_grav/speedfucking)
"pW" = (
/obj/structure/table/wood,
/obj/item/reagent_containers/cup/glass/drinkingglass{
	pixel_x = -5;
	pixel_y = 2
	},
/obj/effect/turf_decal/siding/wood{
	dir = 1
	},
/turf/open/floor/carpet/royalblue,
/area/ruin/space/has_grav/speedfucking)
"qn" = (
/obj/effect/turf_decal/siding/wood{
	dir = 6
	},
/obj/structure/chair/sofa/corner{
	dir = 8;
	color = "922F9E"
	},
/turf/open/floor/carpet/purple,
/area/ruin/space/has_grav/speedfucking)
"qS" = (
/obj/structure/chair/sofa/middle/maroon{
	dir = 1
	},
/obj/effect/turf_decal/siding/wood,
/turf/open/floor/carpet,
/area/ruin/space/has_grav/speedfucking)
"rm" = (
/obj/machinery/vending/cigarette,
/turf/open/floor/wood/large,
/area/ruin/space/has_grav/speedfucking)
"rB" = (
/obj/structure/chair/sofa/bench/left{
	dir = 8
	},
/turf/open/floor/iron,
/area/ruin/space/has_grav/speedfucking)
"sh" = (
/obj/structure/chair/sofa/bench{
	dir = 4
	},
/turf/open/floor/iron,
/area/ruin/space/has_grav/speedfucking)
"sQ" = (
/obj/machinery/light/floor,
/turf/open/floor/iron/edge{
	dir = 8
	},
/area/ruin/space/has_grav/speedfucking)
"tw" = (
/obj/machinery/vending/gato,
/turf/open/floor/wood/large,
/area/ruin/space/has_grav/speedfucking)
"tY" = (
/obj/effect/turf_decal/siding/wood{
	dir = 10
	},
/obj/structure/chair/sofa/corner{
	dir = 1;
	color = "4860E0"
	},
/turf/open/floor/carpet/royalblue,
/area/ruin/space/has_grav/speedfucking)
"uQ" = (
/obj/machinery/light/small/directional/north,
/obj/item/kirbyplants/organic/plant21,
/turf/open/floor/wood/parquet,
/area/ruin/space/has_grav/speedfucking)
"uY" = (
/obj/effect/spawner/structure/window/reinforced,
/obj/structure/curtain/cloth{
	color = "922F9E"
	},
/turf/open/floor/plating,
/area/ruin/space/has_grav/speedfucking)
"vG" = (
/obj/effect/spawner/structure/window/reinforced,
/turf/open/floor/plating,
/area/ruin/space/has_grav/speedfucking)
"vI" = (
/obj/machinery/light/floor,
/turf/open/floor/iron,
/area/ruin/space/has_grav/speedfucking)
"wG" = (
/obj/effect/turf_decal/siding/wideplating{
	dir = 8
	},
/obj/structure/sign/clock/directional/north,
/obj/structure/chair/beanbag/green{
	dir = 8
	},
/turf/open/floor/wood/parquet,
/area/ruin/space/has_grav/speedfucking)
"xe" = (
/obj/effect/turf_decal/siding/wood,
/obj/structure/chair/sofa/middle{
	dir = 1;
	color = "46802F"
	},
/turf/open/floor/carpet/green,
/area/ruin/space/has_grav/speedfucking)
"ye" = (
/obj/structure/chair/sofa/bench/right{
	dir = 8
	},
/turf/open/floor/iron,
/area/ruin/space/has_grav/speedfucking)
"yK" = (
/obj/effect/turf_decal/siding/wood{
	dir = 8
	},
/turf/open/floor/wood/large,
/area/ruin/space/has_grav/speedfucking)
"zr" = (
/obj/structure/chair/sofa/bench/left{
	dir = 4
	},
/turf/open/floor/iron,
/area/ruin/space/has_grav/speedfucking)
"zB" = (
/obj/effect/turf_decal/siding/wood/corner{
	dir = 1
	},
/obj/machinery/vending/mealdor,
/turf/open/floor/wood/large,
/area/ruin/space/has_grav/speedfucking)
"zO" = (
/obj/effect/turf_decal/siding/wood{
	dir = 10
	},
/obj/structure/chair/sofa/corner{
	dir = 1;
	color = "922F9E"
	},
/turf/open/floor/carpet/purple,
/area/ruin/space/has_grav/speedfucking)
"Ah" = (
/obj/effect/spawner/structure/window/reinforced,
/obj/structure/curtain/cloth{
	color = "3B2161"
	},
/turf/open/floor/plating,
/area/ruin/space/has_grav/speedfucking)
"Aq" = (
/obj/structure/table/wood,
/obj/item/reagent_containers/cup/glass/drinkingglass{
	pixel_x = -5;
	pixel_y = 2
	},
/obj/effect/turf_decal/siding/wood{
	dir = 1
	},
/turf/open/floor/carpet,
/area/ruin/space/has_grav/speedfucking)
"Ax" = (
/obj/structure/table/wood,
/obj/effect/turf_decal/siding/wood{
	dir = 10
	},
/turf/open/floor/wood/large,
/area/ruin/space/has_grav/speedfucking)
"AI" = (
/obj/structure/table/wood,
/obj/effect/turf_decal/siding/wood{
	dir = 8
	},
/obj/item/storage/medkit/regular,
/obj/item/storage/medkit/regular,
/obj/item/storage/medkit/regular{
	pixel_x = 0;
	pixel_y = -13
	},
/obj/item/storage/medkit/regular{
	pixel_x = 0;
	pixel_y = -26
	},
/turf/open/floor/wood/large,
/area/ruin/space/has_grav/speedfucking)
"Bj" = (
/obj/structure/chair/sofa/corner/maroon{
	dir = 8
	},
/obj/effect/turf_decal/siding/wood{
	dir = 6
	},
/turf/open/floor/carpet,
/area/ruin/space/has_grav/speedfucking)
"Bq" = (
/obj/effect/turf_decal/arrows/white{
	dir = 1
	},
/obj/machinery/light/floor,
/turf/open/floor/iron/edge{
	dir = 8
	},
/area/ruin/space/has_grav/speedfucking)
"Cg" = (
/obj/effect/turf_decal/siding/wood{
	dir = 9
	},
/obj/structure/chair/sofa/corp/left{
	dir = 4
	},
/turf/open/floor/carpet/royalblack,
/area/ruin/space/has_grav/speedfucking)
"CV" = (
/obj/machinery/vending/hotdog,
/obj/effect/turf_decal/siding/wood/corner,
/turf/open/floor/wood/large,
/area/ruin/space/has_grav/speedfucking)
"Dr" = (
/obj/structure/table/wood,
/obj/item/reagent_containers/cup/glass/bottle/wine{
	pixel_x = 16;
	pixel_y = 6
	},
/obj/item/reagent_containers/cup/glass/drinkingglass{
	pixel_x = 5;
	pixel_y = 2
	},
/obj/effect/turf_decal/siding/wood{
	dir = 1
	},
/turf/open/floor/carpet,
/area/ruin/space/has_grav/speedfucking)
"Du" = (
/obj/structure/table/wood,
/obj/item/reagent_containers/cup/glass/bottle/wine{
	pixel_x = 16;
	pixel_y = 6
	},
/obj/item/reagent_containers/cup/glass/drinkingglass{
	pixel_x = 5;
	pixel_y = 2
	},
/obj/effect/turf_decal/siding/wood{
	dir = 1
	},
/turf/open/floor/carpet/green,
/area/ruin/space/has_grav/speedfucking)
"Dy" = (
/obj/machinery/light/small/directional/south,
/obj/item/kirbyplants/organic/plant21,
/turf/open/floor/wood/parquet,
/area/ruin/space/has_grav/speedfucking)
"DJ" = (
/obj/machinery/vending/clothing,
/turf/open/floor/wood/large,
/area/ruin/space/has_grav/speedfucking)
"DY" = (
/obj/effect/turf_decal/siding/wood{
	dir = 6
	},
/obj/structure/chair/sofa/corner{
	dir = 8;
	color = "3B2161"
	},
/turf/open/floor/carpet/black,
/area/ruin/space/has_grav/speedfucking)
"Eo" = (
/obj/structure/hedge,
/obj/structure/window/fulltile,
/turf/open/floor/plating,
/area/ruin/space/has_grav/speedfucking)
"Eq" = (
/obj/effect/turf_decal/arrows/white{
	dir = 8
	},
/turf/open/floor/iron/corner,
/area/ruin/space/has_grav/speedfucking)
"EM" = (
/obj/structure/chair/sofa/bench{
	dir = 8
	},
/turf/open/floor/iron,
/area/ruin/space/has_grav/speedfucking)
"EO" = (
/obj/effect/turf_decal/siding/wideplating{
	dir = 4
	},
/obj/structure/sign/painting/parting{
	pixel_x = 0;
	pixel_y = 32
	},
/obj/structure/chair/beanbag/purple,
/turf/open/floor/wood/parquet,
/area/ruin/space/has_grav/speedfucking)
"EX" = (
/obj/structure/table/wood,
/obj/effect/turf_decal/siding/wood,
/obj/item/paper_bin,
/obj/item/pen,
/turf/open/floor/wood/large,
/area/ruin/space/has_grav/speedfucking)
"Fd" = (
/obj/effect/turf_decal/siding/wideplating{
	dir = 8
	},
/obj/structure/sign/clock/directional/north,
/obj/structure/chair/beanbag/gato{
	dir = 8
	},
/turf/open/floor/wood/parquet,
/area/ruin/space/has_grav/speedfucking)
"Gw" = (
/turf/open/floor/carpet,
/area/ruin/space/has_grav/speedfucking)
"GM" = (
/obj/structure/table/wood,
/obj/item/reagent_containers/cup/glass/drinkingglass{
	pixel_x = -5;
	pixel_y = 2
	},
/obj/effect/turf_decal/siding/wood{
	dir = 1
	},
/turf/open/floor/carpet/purple,
/area/ruin/space/has_grav/speedfucking)
"GO" = (
/obj/effect/turf_decal/siding/wood{
	dir = 9
	},
/obj/structure/chair/sofa/left/old{
	dir = 4;
	color = "3B2161"
	},
/turf/open/floor/carpet/black,
/area/ruin/space/has_grav/speedfucking)
"He" = (
/obj/effect/turf_decal/siding/wideplating{
	dir = 4
	},
/obj/structure/sign/painting/parting{
	pixel_x = 0;
	pixel_y = 32
	},
/obj/structure/chair/beanbag/gato,
/turf/open/floor/wood/parquet,
/area/ruin/space/has_grav/speedfucking)
"Hn" = (
/obj/effect/turf_decal/siding/wood{
	dir = 10
	},
/obj/structure/chair/sofa/corner{
	dir = 1;
	color = "46802F"
	},
/turf/open/floor/carpet/green,
/area/ruin/space/has_grav/speedfucking)
"Hp" = (
/obj/structure/falsewall,
/turf/open/floor/plating,
/area/ruin/space/has_grav/speedfucking)
"Jb" = (
/turf/open/floor/plating,
/area/ruin/space/has_grav/speedfucking)
"Jm" = (
/obj/effect/turf_decal/siding/wideplating{
	dir = 8
	},
/obj/structure/sign/clock/directional/north,
/obj/structure/chair/beanbag/purple{
	dir = 8
	},
/turf/open/floor/wood/parquet,
/area/ruin/space/has_grav/speedfucking)
"Ko" = (
/obj/effect/turf_decal/siding/wood{
	dir = 5
	},
/obj/structure/chair/sofa/right{
	dir = 8;
	color = "922F9E"
	},
/turf/open/floor/carpet/purple,
/area/ruin/space/has_grav/speedfucking)
"KL" = (
/obj/effect/spawner/structure/window/reinforced,
/obj/structure/curtain/cloth{
	color = "46802F"
	},
/turf/open/floor/plating,
/area/ruin/space/has_grav/speedfucking)
"Lh" = (
/obj/machinery/vending/cigarette,
/obj/effect/turf_decal/siding/wood/corner{
	dir = 8
	},
/turf/open/floor/wood/large,
/area/ruin/space/has_grav/speedfucking)
"Mv" = (
/turf/closed/wall,
/area/ruin/space/has_grav/speedfucking)
"Nh" = (
/obj/effect/turf_decal/siding/wood{
	dir = 6
	},
/obj/structure/chair/sofa/corner{
	dir = 8;
	color = "4860E0"
	},
/turf/open/floor/carpet/royalblue,
/area/ruin/space/has_grav/speedfucking)
"NZ" = (
/obj/effect/turf_decal/siding/wood{
	dir = 5
	},
/obj/structure/chair/sofa/right{
	dir = 8;
	color = "3B2161"
	},
/turf/open/floor/carpet/black,
/area/ruin/space/has_grav/speedfucking)
"Pu" = (
/obj/structure/chair/office,
/turf/open/floor/wood/large,
/area/ruin/space/has_grav/speedfucking)
"QK" = (
/obj/effect/turf_decal/siding/wideplating{
	dir = 1
	},
/turf/open/floor/wood/parquet,
/area/ruin/space/has_grav/speedfucking)
"QO" = (
/obj/effect/turf_decal/siding/wood,
/obj/structure/chair/sofa/middle{
	dir = 1;
	color = "4860E0"
	},
/turf/open/floor/carpet/royalblue,
/area/ruin/space/has_grav/speedfucking)
"Rj" = (
/obj/effect/turf_decal/siding/wood{
	dir = 9
	},
/obj/structure/chair/sofa/left/old{
	dir = 4;
	color = "46802F"
	},
/turf/open/floor/carpet/green,
/area/ruin/space/has_grav/speedfucking)
"Rl" = (
/turf/open/floor/iron/edge{
	dir = 8
	},
/area/ruin/space/has_grav/speedfucking)
"RH" = (
/obj/machinery/light/floor,
/turf/open/floor/iron/edge{
	dir = 1
	},
/area/ruin/space/has_grav/speedfucking)
"So" = (
/obj/structure/table/wood,
/obj/item/reagent_containers/cup/glass/bottle/wine{
	pixel_x = 16;
	pixel_y = 6
	},
/obj/item/reagent_containers/cup/glass/drinkingglass{
	pixel_x = 5;
	pixel_y = 2
	},
/obj/effect/turf_decal/siding/wood{
	dir = 1
	},
/turf/open/floor/carpet/royalblack,
/area/ruin/space/has_grav/speedfucking)
"SS" = (
/turf/open/floor/iron/corner{
	dir = 1
	},
/area/ruin/space/has_grav/speedfucking)
"Ti" = (
/obj/structure/table/wood,
/obj/item/reagent_containers/cup/glass/bottle/wine{
	pixel_x = 16;
	pixel_y = 6
	},
/obj/item/reagent_containers/cup/glass/drinkingglass{
	pixel_x = 5;
	pixel_y = 2
	},
/obj/effect/turf_decal/siding/wood{
	dir = 1
	},
/turf/open/floor/carpet/black,
/area/ruin/space/has_grav/speedfucking)
"Tt" = (
/obj/effect/turf_decal/siding/wood/corner{
	dir = 8
	},
/obj/machinery/vending/dorms,
/turf/open/floor/wood/large,
/area/ruin/space/has_grav/speedfucking)
"TB" = (
/obj/structure/chair/sofa/bench/right{
	dir = 4
	},
/turf/open/floor/iron,
/area/ruin/space/has_grav/speedfucking)
"TP" = (
/obj/structure/chair/sofa/left/maroon{
	dir = 4
	},
/obj/effect/turf_decal/siding/wood{
	dir = 9
	},
/turf/open/floor/carpet,
/area/ruin/space/has_grav/speedfucking)
"Ur" = (
/obj/effect/turf_decal/siding/wideplating/corner{
	dir = 1
	},
/turf/open/floor/wood/parquet,
/area/ruin/space/has_grav/speedfucking)
"UN" = (
/obj/effect/turf_decal/siding/wood{
	dir = 10
	},
/obj/structure/chair/sofa/corp/corner{
	dir = 1
	},
/turf/open/floor/carpet/royalblack,
/area/ruin/space/has_grav/speedfucking)
"UP" = (
/obj/effect/turf_decal/siding/wideplating{
	dir = 8
	},
/obj/structure/sign/clock/directional/north,
/obj/structure/chair/beanbag/blue{
	dir = 8
	},
/turf/open/floor/wood/parquet,
/area/ruin/space/has_grav/speedfucking)
"UT" = (
/obj/structure/table/wood,
/obj/item/reagent_containers/cup/glass/drinkingglass{
	pixel_x = -5;
	pixel_y = 2
	},
/obj/effect/turf_decal/siding/wood{
	dir = 1
	},
/turf/open/floor/carpet/black,
/area/ruin/space/has_grav/speedfucking)
"Vd" = (
/obj/machinery/vending/fatty_items,
/turf/open/floor/plating,
/area/ruin/space/has_grav/speedfucking)
"VH" = (
/turf/open/floor/iron/corner{
	dir = 8
	},
/area/ruin/space/has_grav/speedfucking)
"Xh" = (
/turf/template_noop,
/area/template_noop)
"Xs" = (
/obj/machinery/vending/dorms,
/turf/open/floor/plating,
/area/ruin/space/has_grav/speedfucking)
"Yj" = (
/obj/structure/chair/sofa/corner/maroon{
	dir = 1
	},
/obj/effect/turf_decal/siding/wood{
	dir = 10
	},
/turf/open/floor/carpet,
/area/ruin/space/has_grav/speedfucking)
"Yv" = (
/obj/machinery/light/floor,
/turf/open/floor/iron/edge{
	dir = 4
	},
/area/ruin/space/has_grav/speedfucking)
"YM" = (
/turf/open/floor/iron/corner,
/area/ruin/space/has_grav/speedfucking)
"YX" = (
/obj/effect/turf_decal/siding/wood{
	dir = 5
	},
/obj/structure/chair/sofa/corp/right{
	dir = 8
	},
/turf/open/floor/carpet/royalblack,
/area/ruin/space/has_grav/speedfucking)
"Zk" = (
/obj/structure/fireplace{
	pixel_x = 0;
	pixel_y = -4
	},
/obj/item/stack/sheet/mineral/wood,
/obj/item/stack/sheet/mineral/wood,
/obj/item/stack/sheet/mineral/wood,
/obj/item/stack/sheet/mineral/wood,
/obj/item/stack/sheet/mineral/wood,
/obj/item/stack/sheet/mineral/wood,
/obj/item/stack/sheet/mineral/wood,
/obj/item/stack/sheet/mineral/wood,
/obj/item/stack/sheet/mineral/wood,
/obj/item/stack/sheet/mineral/wood,
/obj/item/stack/sheet/mineral/wood,
/obj/item/stack/sheet/mineral/wood,
/obj/item/stack/sheet/mineral/wood,
/obj/item/stack/sheet/mineral/wood,
/obj/item/stack/sheet/mineral/wood,
/obj/item/stack/sheet/mineral/wood,
/obj/item/stack/sheet/mineral/wood,
/turf/open/floor/stone,
/area/ruin/space/has_grav/speedfucking)
"Zl" = (
/obj/machinery/light/small/directional/north,
/turf/open/floor/wood/parquet,
/area/ruin/space/has_grav/speedfucking)
"Zu" = (
/obj/structure/table/wood,
/obj/effect/turf_decal/siding/wood{
	dir = 4
	},
/obj/item/megaphone/command,
/turf/open/floor/wood/large,
/area/ruin/space/has_grav/speedfucking)
"ZP" = (
/obj/machinery/light/floor,
/turf/open/floor/carpet,
/area/ruin/space/has_grav/speedfucking)
"ZZ" = (
/obj/structure/chair/sofa/right/maroon{
	dir = 8
	},
/obj/effect/turf_decal/siding/wood{
	dir = 5
	},
/turf/open/floor/carpet,
/area/ruin/space/has_grav/speedfucking)

(1,1,1) = {"
Xh
Xh
Xh
Xh
Xh
Xh
Xh
Xh
Xh
Xh
Xh
Xh
Xh
Xh
Xh
Xh
Xh
Xh
Xh
Xh
Xh
Xh
Xh
Xh
Xh
Xh
Xh
Xh
Xh
Xh
Xh
Xh
Xh
Xh
Xh
Xh
Xh
Xh
"}
(2,1,1) = {"
Xh
gH
gH
gH
Mv
Mv
Mv
Mv
Mv
Mv
Xh
Xh
Mv
Mv
Mv
Mv
Mv
Mv
Xh
Xh
Mv
Mv
Mv
Mv
Mv
Mv
Xh
Xh
Mv
gH
gH
gH
gH
gH
gH
Mv
gH
Xh
"}
(3,1,1) = {"
Xh
gH
Xh
Xh
Mv
ew
Eo
Eo
ew
Mv
gH
gH
Mv
ew
Eo
Eo
ew
Mv
gH
gH
Mv
ew
Eo
Eo
ew
Mv
gH
gH
Mv
Mv
Mv
Mv
Mv
Mv
Mv
Mv
gH
Xh
"}
(4,1,1) = {"
Xh
gH
Xh
Xh
Mv
He
iX
GO
fe
Ah
Xh
Xh
Mv
kr
iX
Rj
Hn
KL
Xh
Xh
Mv
EO
iX
ln
zO
uY
Xh
Xh
Mv
YM
sQ
Rl
Rl
sQ
gU
Mv
gH
Xh
"}
(5,1,1) = {"
Xh
gH
gH
gH
Mv
Zk
QK
Ti
dI
Ah
Xh
Xh
Mv
Zk
QK
Du
xe
KL
Xh
Xh
Mv
Zk
QK
fL
jI
uY
Xh
Xh
Mv
fz
ye
EM
EM
rB
fv
Mv
gH
Xh
"}
(6,1,1) = {"
Xh
gH
Xh
Xh
Mv
dF
QK
UT
dI
Ah
Xh
Xh
Mv
dF
QK
ap
xe
KL
Xh
Xh
Mv
dF
QK
GM
jI
uY
Xh
Xh
Mv
fz
zr
sh
sh
TB
fv
Mv
gH
Xh
"}
(7,1,1) = {"
Xh
gH
Xh
Xh
Mv
Fd
Ur
NZ
DY
Ah
Xh
Xh
Mv
wG
Ur
pn
if
KL
Xh
Xh
Mv
Jm
Ur
Ko
qn
uY
Xh
Xh
Mv
hj
dx
cF
cF
vI
fv
Mv
gH
Xh
"}
(8,1,1) = {"
Xh
Mv
Mv
Mv
Mv
uQ
mf
mf
Dy
Mv
vG
vG
Mv
uQ
mf
mf
Dy
Mv
vG
vG
Mv
Zl
mf
mf
Dy
Mv
vG
vG
Mv
yK
yK
AI
Ax
fz
fv
Mv
Mv
Xh
"}
(9,1,1) = {"
Xh
Mv
Vd
Mv
Tt
yK
yK
yK
yK
zB
tw
DJ
Lh
yK
yK
yK
yK
zB
tw
DJ
Lh
yK
yK
yK
yK
zB
tw
DJ
rm
jf
jf
jf
EX
fz
fv
lE
Mv
Xh
"}
(10,1,1) = {"
Xh
Mv
Jb
Hp
jf
ZP
Gw
Gw
Gw
ZP
Gw
Gw
ZP
Gw
Gw
Gw
Gw
ZP
Gw
Gw
ZP
Gw
Gw
Gw
Gw
ZP
Gw
Gw
ZP
jf
jf
Pu
cU
RH
fv
of
Mv
Xh
"}
(11,1,1) = {"
Xh
Mv
Xs
Mv
ii
ib
ib
ib
ib
fT
bA
jJ
CV
ib
ib
ib
ib
fT
bA
jJ
CV
ib
ib
ib
ib
fT
bA
jJ
ic
jf
jf
jf
cU
fz
fv
lE
Mv
Xh
"}
(12,1,1) = {"
Xh
Mv
Mv
Mv
Mv
uQ
mf
mf
Dy
Mv
vG
vG
Mv
uQ
mf
mf
Dy
Mv
vG
vG
Mv
uQ
mf
mf
Dy
Mv
vG
vG
Mv
ib
ib
Zu
ft
fz
fv
Mv
Mv
Xh
"}
(13,1,1) = {"
Xh
gH
Xh
Xh
Mv
pI
iX
Cg
UN
iT
Xh
Xh
Mv
ng
iX
kM
tY
pa
Xh
Xh
Mv
hI
iX
TP
Yj
mn
Xh
Xh
Mv
Eq
Bq
hk
hk
vI
fv
Mv
gH
Xh
"}
(14,1,1) = {"
Xh
gH
Xh
Xh
Mv
Zk
QK
So
eL
iT
Xh
Xh
Mv
Zk
QK
gD
QO
pa
Xh
Xh
Mv
Zk
QK
Dr
qS
mn
Xh
Xh
Mv
fz
ye
EM
EM
rB
fv
Mv
gH
Xh
"}
(15,1,1) = {"
Xh
gH
gH
gH
Mv
dF
QK
mE
eL
iT
Xh
Xh
Mv
dF
QK
pW
QO
pa
Xh
Xh
Mv
dF
QK
Aq
qS
mn
Xh
Xh
Mv
fz
zr
sh
sh
TB
fv
Mv
gH
Xh
"}
(16,1,1) = {"
Xh
gH
Xh
Xh
Mv
mZ
Ur
YX
or
iT
Xh
Xh
Mv
UP
Ur
bx
Nh
pa
Xh
Xh
Mv
eP
Ur
ZZ
Bj
mn
Xh
Xh
Mv
VH
Yv
ke
ke
Yv
SS
Mv
gH
Xh
"}
(17,1,1) = {"
Xh
gH
Xh
Xh
Mv
ew
Eo
Eo
ew
Mv
gH
gH
Mv
ew
Eo
Eo
ew
Mv
gH
gH
Mv
ew
Eo
Eo
ew
Mv
gH
gH
Mv
Mv
Mv
Mv
Mv
Mv
Mv
Mv
gH
Xh
"}
(18,1,1) = {"
Xh
gH
gH
gH
Mv
Mv
Mv
Mv
Mv
Mv
Xh
Xh
Mv
Mv
Mv
Mv
Mv
Mv
Xh
Xh
Mv
Mv
Mv
Mv
Mv
Mv
Xh
Xh
Mv
gH
gH
gH
gH
gH
gH
Mv
gH
Xh
"}
(19,1,1) = {"
Xh
Xh
Xh
Xh
Xh
Xh
Xh
Xh
Xh
Xh
Xh
Xh
Xh
Xh
Xh
Xh
Xh
Xh
Xh
Xh
Xh
Xh
Xh
Xh
Xh
Xh
Xh
Xh
Xh
Xh
Xh
Xh
Xh
Xh
Xh
Xh
Xh
Xh
"}
