//MAP CONVERTED BY dmm2tgm.py THIS HEADER COMMENT PREVENTS RECONVERSION, DO NOT REMOVE
"a" = (
/turf/closed/indestructible/chocolate,
/area/ruin/unpowered)
"b" = (
/obj/item/food/bonbon/chocolate_truffle,
/turf/open/indestructible/chocolate,
/area/ruin/unpowered)
"c" = (
/obj/item/food/donut/choco{
	pixel_x = -6;
	pixel_y = -9
	},
/turf/open/indestructible/chocolate,
/area/ruin/unpowered)
"d" = (
/obj/item/food/cakeslice/chocolate{
	pixel_x = 5;
	pixel_y = -7
	},
/turf/open/indestructible/chocolate,
/area/ruin/unpowered)
"e" = (
/obj/item/food/donut/choco{
	pixel_x = 9;
	pixel_y = 10
	},
/turf/open/indestructible/chocolate,
/area/ruin/unpowered)
"f" = (
/obj/item/food/cake/berry_chocolate_cake,
/turf/open/indestructible/chocolate,
/area/ruin/unpowered)
"g" = (
/obj/item/reagent_containers/condiment/chocolate{
	pixel_x = 16;
	pixel_y = 4
	},
/turf/open/indestructible/chocolate,
/area/ruin/unpowered)
"h" = (
/obj/item/food/cookie/chocolate_chip_cookie{
	pixel_x = -15;
	pixel_y = -8
	},
/turf/open/indestructible/chocolate,
/area/ruin/unpowered)
"i" = (
/obj/effect/light_emitter/tendril,
/turf/open/chocolateriver,
/area/ruin/unpowered)
"j" = (
/obj/item/food/cakeslice/chocolate{
	pixel_x = 11;
	pixel_y = 11
	},
/turf/open/indestructible/chocolate,
/area/ruin/unpowered)
"l" = (
/obj/item/food/bonbon/chocolate_truffle{
	pixel_x = 12;
	pixel_y = -4
	},
/turf/open/indestructible/chocolate,
/area/ruin/unpowered)
"m" = (
/mob/living/simple_animal/hostile/feed/chocolate_slime,
/turf/open/indestructible/chocolate,
/area/ruin/unpowered)
"q" = (
/obj/item/food/cookie/chocolate_chip_cookie{
	pixel_x = 13;
	pixel_y = -5
	},
/turf/open/indestructible/chocolate,
/area/ruin/unpowered)
"s" = (
/obj/item/food/bonbon/chocolate_truffle{
	pixel_x = 10;
	pixel_y = 1
	},
/turf/open/indestructible/chocolate,
/area/ruin/unpowered)
"t" = (
/obj/item/food/chocolatebunny{
	pixel_x = -2;
	pixel_y = -8
	},
/obj/item/food/chocolateegg{
	pixel_x = 10;
	pixel_y = -10
	},
/obj/item/food/chocolateegg{
	pixel_x = 9;
	pixel_y = 13
	},
/turf/open/indestructible/chocolate,
/area/ruin/unpowered)
"u" = (
/obj/item/food/cakeslice/chocolate{
	pixel_x = 0;
	pixel_y = 6
	},
/turf/open/indestructible/chocolate,
/area/ruin/unpowered)
"v" = (
/obj/item/food/cookie/chocolate_chip_cookie{
	pixel_x = -6;
	pixel_y = 7
	},
/turf/open/indestructible/chocolate,
/area/ruin/unpowered)
"x" = (
/obj/item/food/cookie/chocolate_chip_cookie{
	pixel_x = -3;
	pixel_y = -6
	},
/turf/open/indestructible/chocolate,
/area/ruin/unpowered)
"y" = (
/obj/item/food/cookie/chocolate_chip_cookie{
	pixel_x = 11;
	pixel_y = -8
	},
/turf/open/indestructible/chocolate,
/area/ruin/unpowered)
"z" = (
/turf/closed/indestructible/rock,
/area/lavaland/surface/outdoors)
"A" = (
/obj/item/food/chocolatebunny{
	pixel_x = -14;
	pixel_y = -4
	},
/obj/item/food/chocolateegg{
	pixel_x = 12;
	pixel_y = 8
	},
/turf/open/indestructible/chocolate,
/area/ruin/unpowered)
"C" = (
/obj/item/food/chocolatebunny,
/obj/item/food/chocolateegg{
	pixel_x = 4;
	pixel_y = 10
	},
/obj/item/food/chocolateegg{
	pixel_x = 14;
	pixel_y = 6
	},
/turf/open/indestructible/chocolate,
/area/ruin/unpowered)
"D" = (
/obj/item/food/cookie/chocolate_chip_cookie{
	pixel_x = -4;
	pixel_y = 10
	},
/turf/open/indestructible/chocolate,
/area/ruin/unpowered)
"E" = (
/obj/item/food/donut/choco{
	pixel_x = 3;
	pixel_y = -16
	},
/turf/open/indestructible/chocolate,
/area/ruin/unpowered)
"F" = (
/obj/structure/fans/tiny/invisible,
/obj/structure/mineral_door/wood,
/obj/structure/barricade/wooden/crude,
/turf/open/indestructible/chocolate,
/area/ruin/unpowered)
"H" = (
/obj/item/food/cookie/chocolate_chip_cookie{
	pixel_x = -4;
	pixel_y = -8
	},
/turf/open/indestructible/chocolate,
/area/ruin/unpowered)
"J" = (
/obj/item/food/donut/choco{
	pixel_x = 1;
	pixel_y = 4
	},
/turf/open/indestructible/chocolate,
/area/ruin/unpowered)
"M" = (
/obj/item/food/cookie/chocolate_chip_cookie{
	pixel_x = -9;
	pixel_y = 6
	},
/turf/open/indestructible/chocolate,
/area/ruin/unpowered)
"N" = (
/obj/item/food/donut/choco{
	pixel_x = 11;
	pixel_y = 6
	},
/turf/open/indestructible/chocolate,
/area/ruin/unpowered)
"O" = (
/obj/item/food/cakeslice/chocolate{
	pixel_x = 5;
	pixel_y = -4
	},
/turf/open/indestructible/chocolate,
/area/ruin/unpowered)
"P" = (
/obj/item/reagent_containers/condiment/chocolate,
/turf/open/indestructible/chocolate,
/area/ruin/unpowered)
"Q" = (
/turf/open/chocolateriver,
/area/ruin/unpowered)
"R" = (
/obj/item/food/bonbon/chocolate_truffle{
	pixel_x = -5;
	pixel_y = -1
	},
/turf/open/indestructible/chocolate,
/area/ruin/unpowered)
"S" = (
/obj/item/food/bonbon/chocolate_truffle{
	pixel_x = 7;
	pixel_y = -5
	},
/turf/open/indestructible/chocolate,
/area/ruin/unpowered)
"T" = (
/obj/item/food/donut/choco{
	pixel_x = -5;
	pixel_y = -16
	},
/turf/open/indestructible/chocolate,
/area/ruin/unpowered)
"U" = (
/turf/template_noop,
/area/template_noop)
"V" = (
/mob/living/simple_animal/hostile/feed/chocolate_slime,
/obj/item/food/chocolateegg,
/turf/open/indestructible/chocolate,
/area/ruin/unpowered)
"X" = (
/obj/item/food/bonbon/chocolate_truffle{
	pixel_x = -8;
	pixel_y = -9
	},
/turf/open/indestructible/chocolate,
/area/ruin/unpowered)
"Y" = (
/turf/open/indestructible/chocolate,
/area/ruin/unpowered)
"Z" = (
/obj/item/food/cakeslice/chocolate{
	pixel_x = 0;
	pixel_y = 10
	},
/turf/open/indestructible/chocolate,
/area/ruin/unpowered)

(1,1,1) = {"
U
U
U
U
U
z
z
z
z
z
U
U
U
U
U
z
z
z
U
U
"}
(2,1,1) = {"
U
z
z
z
z
z
z
z
z
z
z
z
z
z
z
z
z
z
z
U
"}
(3,1,1) = {"
U
z
a
a
a
a
a
a
a
a
a
a
a
z
z
a
F
a
z
z
"}
(4,1,1) = {"
U
z
a
f
m
b
Y
Y
Y
Y
t
C
a
z
z
a
i
a
z
z
"}
(5,1,1) = {"
U
z
a
P
Q
Q
i
Q
Q
Y
V
A
a
z
z
a
Q
a
z
z
"}
(6,1,1) = {"
z
z
a
Q
Q
Q
Q
Q
Q
Q
P
Y
a
a
a
a
Q
a
a
z
"}
(7,1,1) = {"
z
z
a
i
Q
y
a
a
Q
Q
Y
Y
Y
Y
m
Y
i
S
a
z
"}
(8,1,1) = {"
z
z
a
Q
q
D
a
a
Q
i
Q
Y
X
Y
S
Q
Q
Y
a
z
"}
(9,1,1) = {"
z
z
a
H
Y
x
v
Y
e
Q
Q
P
a
a
Q
Q
Q
Y
a
z
"}
(10,1,1) = {"
z
z
a
Y
m
Y
Y
m
Y
Q
Q
Y
a
a
i
Q
s
Y
a
z
"}
(11,1,1) = {"
U
z
a
Y
M
h
Y
Y
J
Y
Q
m
a
a
Q
u
Y
Y
a
z
"}
(12,1,1) = {"
U
z
a
Y
Y
P
Y
a
a
a
i
Y
a
a
Q
Y
a
a
a
z
"}
(13,1,1) = {"
U
z
a
a
a
N
Y
a
a
a
Q
Q
d
Q
i
l
a
z
z
z
"}
(14,1,1) = {"
U
z
z
z
a
Y
Y
T
Y
j
Q
i
Q
Q
Q
Y
a
z
z
U
"}
(15,1,1) = {"
U
U
z
z
a
E
Y
Y
Y
Y
m
Q
Q
Q
R
Y
a
z
U
U
"}
(16,1,1) = {"
U
U
U
z
a
Y
a
a
a
c
Y
Y
Z
g
m
Y
a
z
U
U
"}
(17,1,1) = {"
U
U
U
z
a
F
a
z
a
O
Y
Y
Y
Y
Y
Y
a
z
U
U
"}
(18,1,1) = {"
U
U
U
z
z
z
z
z
a
a
a
a
a
a
a
a
a
z
U
U
"}
(19,1,1) = {"
U
U
U
U
z
z
z
z
z
z
z
z
z
z
z
z
z
z
U
U
"}
(20,1,1) = {"
U
U
U
U
U
U
z
z
z
z
z
z
z
U
U
U
U
U
U
U
"}
