//MAP CONVERTED BY dmm2tgm.py THIS HEADER COMMENT PREVENTS RECONVERSION, DO NOT REMOVE
"am" = (
/obj/structure/stone_tile/block{
	dir = 8
	},
/obj/structure/stone_tile,
/turf/open/water/jungle,
/area/ruin/unpowered)
"aw" = (
/obj/structure/stone_tile/surrounding,
/turf/open/water/jungle,
/area/ruin/unpowered)
"bV" = (
/obj/structure/railing{
	dir = 1;
	color = "#895129"
	},
/obj/structure/railing{
	dir = 2;
	color = "#895129"
	},
/obj/effect/turf_decal/siding/wideplating_new/dark{
	dir = 1
	},
/obj/effect/turf_decal/siding/wood{
	dir = 1
	},
/obj/effect/turf_decal/siding/wideplating_new/dark,
/obj/effect/turf_decal/siding/wood,
/turf/open/floor/wood/stairs/left,
/area/ruin/unpowered)
"cZ" = (
/obj/structure/stone_tile/cracked{
	dir = 1
	},
/turf/open/water/jungle,
/area/ruin/unpowered)
"de" = (
/obj/structure/stone_tile,
/obj/structure/stone_tile{
	dir = 4
	},
/turf/open/water/jungle,
/area/ruin/unpowered)
"eh" = (
/obj/structure/stone_tile/block,
/turf/open/water/jungle,
/area/ruin/unpowered)
"fd" = (
/obj/effect/turf_decal/siding/wideplating_new/dark{
	dir = 1
	},
/obj/effect/turf_decal/siding/wood{
	dir = 1
	},
/obj/structure/railing{
	dir = 1;
	color = "#895129"
	},
/turf/open/floor/carpet/royalblue,
/area/ruin/unpowered)
"gf" = (
/obj/item/food/grown/berries/blueberry{
	pixel_x = -12;
	pixel_y = 6
	},
/obj/item/food/grown/berries/blueberry{
	pixel_x = 5;
	pixel_y = 4
	},
/turf/open/floor/engine/cult{
	initial_gas_mix = "LAVALAND_ATMOS"
	},
/area/ruin/unpowered)
"gt" = (
/obj/effect/turf_decal/siding/wideplating_new/dark{
	dir = 10
	},
/obj/effect/turf_decal/siding/wideplating_new/dark/corner{
	dir = 4
	},
/obj/effect/turf_decal/siding/wood{
	dir = 10
	},
/obj/effect/turf_decal/siding/wood/corner{
	dir = 4
	},
/obj/structure/railing{
	dir = 10;
	color = "#895129"
	},
/obj/structure/railing/corner{
	color = "#895129";
	dir = 4
	},
/obj/structure/railing/corner{
	color = "#895129";
	dir = 4
	},
/turf/open/floor/wood/large,
/area/ruin/unpowered)
"gG" = (
/obj/structure/stone_tile/block{
	dir = 1
	},
/turf/open/water/jungle,
/area/ruin/unpowered)
"gJ" = (
/turf/open/water/jungle,
/area/ruin/unpowered)
"gK" = (
/obj/structure/stone_tile,
/turf/open/misc/asteroid/basalt/lava_land_surface,
/area/lavaland/surface/outdoors)
"hx" = (
/obj/structure/stone_tile/surrounding/cracked,
/turf/open/water/jungle,
/area/ruin/unpowered)
"hN" = (
/obj/effect/decal/cleanable/blood/splatter{
	color = "0000FF"
	},
/obj/effect/decal/cleanable/shreds,
/turf/open/floor/engine/cult{
	initial_gas_mix = "LAVALAND_ATMOS"
	},
/area/ruin/unpowered)
"iK" = (
/obj/item/food/grown/berries/blueberry{
	pixel_x = -3;
	pixel_y = 1
	},
/turf/open/floor/engine/cult{
	initial_gas_mix = "LAVALAND_ATMOS"
	},
/area/ruin/unpowered)
"lc" = (
/obj/structure/fans/tiny/invisible,
/obj/structure/stone_tile/slab,
/obj/structure/mineral_door/sandstone{
	color = "#3D2412"
	},
/turf/open/floor/engine/cult{
	initial_gas_mix = "LAVALAND_ATMOS"
	},
/area/ruin/unpowered)
"lK" = (
/obj/structure/stone_tile/block{
	dir = 4
	},
/obj/structure/stone_tile{
	dir = 8
	},
/turf/open/water/jungle,
/area/ruin/unpowered)
"md" = (
/obj/item/food/grown/berries/blueberry{
	pixel_x = -4;
	pixel_y = 2
	},
/obj/item/food/grown/berries/blueberry{
	pixel_x = 13;
	pixel_y = 14
	},
/turf/open/floor/engine/cult{
	initial_gas_mix = "LAVALAND_ATMOS"
	},
/area/ruin/unpowered)
"my" = (
/obj/structure/stone_tile/slab,
/turf/open/misc/asteroid/basalt/lava_land_surface,
/area/lavaland/surface/outdoors)
"ny" = (
/obj/item/food/grown/berries/blueberry{
	pixel_x = -8;
	pixel_y = 14
	},
/obj/item/flashlight/lantern/on,
/obj/item/food/grown/berries/blueberry{
	pixel_x = -3;
	pixel_y = 2
	},
/turf/open/floor/engine/cult{
	initial_gas_mix = "LAVALAND_ATMOS"
	},
/area/ruin/unpowered)
"ol" = (
/obj/structure/railing/corner/end{
	color = "#895129";
	dir = 4
	},
/obj/structure/railing/corner/end/flip{
	color = "#895129";
	dir = 4
	},
/turf/open/floor/engine/cult{
	initial_gas_mix = "LAVALAND_ATMOS"
	},
/area/ruin/unpowered)
"oJ" = (
/obj/structure/stone_tile/surrounding/cracked{
	dir = 8
	},
/turf/open/water/jungle,
/area/ruin/unpowered)
"qe" = (
/obj/structure/stone_tile{
	dir = 4
	},
/turf/open/water/jungle,
/area/ruin/unpowered)
"qL" = (
/obj/structure/stone_tile/block/cracked{
	dir = 1
	},
/turf/open/water/jungle,
/area/ruin/unpowered)
"sa" = (
/obj/structure/railing/corner/end{
	color = "#895129";
	dir = 4
	},
/obj/structure/railing/corner/end/flip{
	color = "#895129";
	dir = 4
	},
/obj/effect/turf_decal/trimline/red/filled/corner,
/obj/effect/turf_decal/trimline/blue/corner,
/obj/effect/decal/cleanable/blood/gibs{
	color = "0000FF"
	},
/obj/effect/decal/cleanable/shreds,
/turf/open/floor/engine/cult{
	initial_gas_mix = "LAVALAND_ATMOS"
	},
/area/ruin/unpowered)
"sq" = (
/obj/effect/turf_decal/siding/wideplating_new/dark{
	dir = 4
	},
/obj/effect/turf_decal/siding/wideplating_new/dark{
	dir = 8
	},
/obj/effect/turf_decal/siding/wood{
	dir = 4
	},
/obj/effect/turf_decal/siding/wood{
	dir = 8
	},
/obj/structure/railing{
	dir = 4;
	color = "#895129"
	},
/obj/structure/railing{
	dir = 8;
	color = "#895129"
	},
/turf/open/floor/wood/large,
/area/ruin/unpowered)
"sr" = (
/obj/structure/stone_tile{
	dir = 8
	},
/turf/open/water/jungle,
/area/ruin/unpowered)
"su" = (
/obj/structure/stone_tile/surrounding/cracked{
	dir = 5
	},
/turf/open/water/jungle,
/area/ruin/unpowered)
"sw" = (
/obj/effect/turf_decal/siding/wideplating_new/dark{
	dir = 6
	},
/obj/effect/turf_decal/siding/wood{
	dir = 4
	},
/obj/effect/turf_decal/siding/wood/corner{
	dir = 8
	},
/obj/structure/railing{
	dir = 4;
	color = "#895129"
	},
/obj/structure/railing/corner{
	color = "#895129";
	dir = 8
	},
/turf/open/floor/carpet/royalblue,
/area/ruin/unpowered)
"tf" = (
/obj/structure/stone_tile,
/turf/open/water/jungle,
/area/ruin/unpowered)
"tg" = (
/obj/structure/stone_tile/block{
	dir = 8
	},
/obj/structure/stone_tile,
/turf/open/misc/asteroid/basalt/lava_land_surface,
/area/lavaland/surface/outdoors)
"uj" = (
/obj/structure/stone_tile{
	dir = 4
	},
/turf/open/misc/asteroid/basalt/lava_land_surface,
/area/lavaland/surface/outdoors)
"vm" = (
/obj/structure/railing/corner/end/flip{
	color = "#895129";
	dir = 1
	},
/obj/structure/railing/corner/end{
	color = "#895129";
	dir = 1
	},
/obj/structure/stone_tile/slab,
/turf/open/floor/engine/cult{
	initial_gas_mix = "LAVALAND_ATMOS"
	},
/area/ruin/unpowered)
"wd" = (
/obj/effect/turf_decal/siding/wideplating_new/dark,
/obj/effect/turf_decal/siding/wood,
/obj/structure/railing{
	dir = 2;
	color = "#895129"
	},
/turf/open/floor/carpet/royalblue,
/area/ruin/unpowered)
"yf" = (
/obj/effect/turf_decal/siding/wideplating_new/dark{
	dir = 4
	},
/obj/effect/turf_decal/siding/wood{
	dir = 4
	},
/obj/structure/railing{
	dir = 4;
	color = "#895129"
	},
/turf/open/floor/carpet/royalblue,
/area/ruin/unpowered)
"yl" = (
/obj/structure/stone_tile/cracked{
	dir = 1
	},
/obj/structure/stone_tile{
	dir = 8
	},
/turf/open/water/jungle,
/area/ruin/unpowered)
"yt" = (
/obj/effect/turf_decal/siding/wideplating_new/dark{
	dir = 9
	},
/obj/effect/turf_decal/siding/wideplating_new/dark/corner,
/obj/effect/turf_decal/siding/wood{
	dir = 9
	},
/obj/effect/turf_decal/siding/wood/corner,
/obj/structure/railing{
	dir = 9;
	color = "#895129"
	},
/obj/structure/railing/corner{
	color = "#895129"
	},
/turf/open/floor/wood/large,
/area/ruin/unpowered)
"yE" = (
/obj/structure/stone_tile/slab,
/turf/open/floor/engine/cult{
	initial_gas_mix = "LAVALAND_ATMOS"
	},
/area/ruin/unpowered)
"zb" = (
/obj/structure/stone_tile/cracked{
	dir = 8
	},
/turf/open/water/jungle,
/area/ruin/unpowered)
"zp" = (
/obj/structure/stone_tile/block{
	dir = 4
	},
/obj/structure/stone_tile{
	dir = 8
	},
/turf/open/misc/asteroid/basalt/lava_land_surface,
/area/lavaland/surface/outdoors)
"Al" = (
/obj/structure/stone_tile{
	dir = 4
	},
/obj/structure/stone_tile,
/turf/open/water/jungle,
/area/ruin/unpowered)
"Aq" = (
/obj/structure/stone_tile/block{
	dir = 4
	},
/turf/open/water/jungle,
/area/ruin/unpowered)
"Ax" = (
/obj/effect/turf_decal/siding/wideplating_new/dark{
	dir = 4
	},
/obj/effect/turf_decal/siding/wideplating_new/dark{
	dir = 8
	},
/obj/effect/turf_decal/siding/wood{
	dir = 4
	},
/obj/effect/turf_decal/siding/wood{
	dir = 8
	},
/obj/structure/railing{
	dir = 4;
	color = "#895129"
	},
/obj/structure/railing{
	dir = 8;
	color = "#895129"
	},
/obj/effect/decal/cleanable/blood/drip{
	pixel_x = 9;
	pixel_y = 2;
	color = "0000FF"
	},
/turf/open/floor/wood/stairs/down,
/area/ruin/unpowered)
"Ay" = (
/obj/structure/stone_tile/surrounding_tile,
/turf/open/water/jungle,
/area/ruin/unpowered)
"AF" = (
/turf/open/floor/engine/cult{
	initial_gas_mix = "LAVALAND_ATMOS"
	},
/area/ruin/unpowered)
"Bl" = (
/obj/item/flashlight/lantern/on,
/turf/open/floor/engine/cult{
	initial_gas_mix = "LAVALAND_ATMOS"
	},
/area/ruin/unpowered)
"Cl" = (
/turf/closed/mineral/volcanic/lava_land_surface,
/area/lavaland/surface/outdoors)
"Cp" = (
/obj/structure/stone_tile/surrounding/cracked{
	dir = 4
	},
/turf/open/water/jungle,
/area/ruin/unpowered)
"EA" = (
/obj/item/clothing/under/color/dual_tone/security{
	pixel_x = 10;
	pixel_y = -15
	},
/turf/open/floor/engine/cult{
	initial_gas_mix = "LAVALAND_ATMOS"
	},
/area/ruin/unpowered)
"EN" = (
/obj/structure/stone_tile{
	dir = 8
	},
/turf/open/misc/asteroid/basalt/lava_land_surface,
/area/lavaland/surface/outdoors)
"Ff" = (
/obj/structure/stone_tile/block/cracked{
	dir = 4
	},
/turf/open/water/jungle,
/area/ruin/unpowered)
"Gn" = (
/obj/effect/turf_decal/siding/wideplating_new/dark{
	dir = 5
	},
/obj/effect/turf_decal/siding/wood{
	dir = 4
	},
/obj/effect/turf_decal/siding/wood/corner{
	dir = 1
	},
/obj/structure/railing{
	dir = 4;
	color = "#895129"
	},
/obj/structure/railing/corner{
	color = "#895129";
	dir = 1
	},
/turf/open/floor/carpet/royalblue,
/area/ruin/unpowered)
"GS" = (
/obj/structure/railing{
	dir = 1;
	color = "#895129"
	},
/obj/structure/railing{
	dir = 2;
	color = "#895129"
	},
/obj/effect/turf_decal/siding/wideplating_new/dark{
	dir = 1
	},
/obj/effect/turf_decal/siding/wood{
	dir = 1
	},
/obj/effect/turf_decal/siding/wideplating_new/dark,
/obj/effect/turf_decal/siding/wood,
/turf/open/floor/wood/stairs/right,
/area/ruin/unpowered)
"HK" = (
/obj/effect/turf_decal/siding/wideplating_new/dark{
	dir = 10
	},
/obj/effect/turf_decal/siding/wood{
	dir = 8
	},
/obj/effect/turf_decal/siding/wood/corner,
/obj/structure/railing{
	dir = 8;
	color = "#895129"
	},
/obj/structure/railing/corner{
	color = "#895129"
	},
/turf/open/floor/carpet/royalblue,
/area/ruin/unpowered)
"Ik" = (
/obj/effect/turf_decal/siding/wideplating_new/dark{
	dir = 6
	},
/obj/effect/turf_decal/siding/wideplating_new/dark/corner{
	dir = 1
	},
/obj/effect/turf_decal/siding/wood{
	dir = 6
	},
/obj/effect/turf_decal/siding/wood/corner{
	dir = 1
	},
/obj/structure/railing{
	dir = 6;
	color = "#895129"
	},
/obj/structure/railing/corner{
	color = "#895129";
	dir = 1
	},
/turf/open/floor/wood/large,
/area/ruin/unpowered)
"IZ" = (
/turf/open/misc/asteroid/basalt/lava_land_surface,
/area/lavaland/surface/outdoors)
"Je" = (
/obj/structure/stone_tile/block/cracked{
	dir = 8
	},
/turf/open/water/jungle,
/area/ruin/unpowered)
"Jj" = (
/obj/effect/turf_decal/siding/wideplating_new/dark{
	dir = 5
	},
/obj/effect/turf_decal/siding/wideplating_new/dark/corner{
	dir = 8
	},
/obj/effect/turf_decal/siding/wood{
	dir = 5
	},
/obj/effect/turf_decal/siding/wood/corner{
	dir = 8
	},
/obj/structure/railing{
	dir = 5;
	color = "#895129"
	},
/obj/structure/railing/corner{
	color = "#895129";
	dir = 8
	},
/obj/effect/decal/cleanable/blood/drip{
	color = "0000FF"
	},
/turf/open/floor/wood/large,
/area/ruin/unpowered)
"Jx" = (
/obj/structure/stone_tile{
	dir = 1
	},
/turf/open/water/jungle,
/area/ruin/unpowered)
"JD" = (
/obj/structure/stone_tile{
	dir = 8
	},
/obj/structure/stone_tile{
	dir = 1
	},
/turf/open/water/jungle,
/area/ruin/unpowered)
"JO" = (
/obj/structure/stone_tile/block{
	dir = 8
	},
/obj/structure/stone_tile{
	dir = 1
	},
/turf/open/water/jungle,
/area/ruin/unpowered)
"Kf" = (
/turf/closed/indestructible/riveted/boss,
/area/ruin/unpowered)
"KY" = (
/obj/structure/stone_tile/surrounding_tile{
	dir = 4
	},
/turf/open/water/jungle,
/area/ruin/unpowered)
"LV" = (
/obj/structure/stone_tile{
	dir = 1
	},
/turf/open/misc/asteroid/basalt/lava_land_surface,
/area/lavaland/surface/outdoors)
"Mc" = (
/obj/effect/turf_decal/siding/wideplating_new/dark{
	dir = 9
	},
/obj/effect/turf_decal/siding/wood{
	dir = 8
	},
/obj/effect/turf_decal/siding/wood/corner{
	dir = 4
	},
/obj/structure/railing{
	dir = 8;
	color = "#895129"
	},
/obj/structure/railing/corner{
	color = "#895129";
	dir = 4
	},
/obj/effect/decal/cleanable/blood/drip{
	color = "0000FF"
	},
/obj/effect/decal/cleanable/blood/drip{
	pixel_x = 4;
	pixel_y = 9;
	color = "0000FF"
	},
/obj/effect/decal/cleanable/blood/drip{
	pixel_x = 13;
	pixel_y = 7;
	color = "0000FF"
	},
/turf/open/floor/carpet/royalblue,
/area/ruin/unpowered)
"Mi" = (
/obj/effect/turf_decal/siding/wideplating_new/dark{
	dir = 8
	},
/obj/effect/turf_decal/siding/wood{
	dir = 8
	},
/obj/structure/railing{
	dir = 8;
	color = "#895129"
	},
/turf/open/floor/carpet/royalblue,
/area/ruin/unpowered)
"Ny" = (
/obj/item/food/grown/berries/blueberry{
	pixel_x = -14;
	pixel_y = 2
	},
/obj/item/food/grown/berries/blueberry{
	pixel_x = 3;
	pixel_y = 1
	},
/obj/item/food/grown/berries/blueberry{
	pixel_x = -2;
	pixel_y = 16
	},
/turf/open/floor/engine/cult{
	initial_gas_mix = "LAVALAND_ATMOS"
	},
/area/ruin/unpowered)
"NU" = (
/obj/effect/turf_decal/siding/wideplating_new/dark{
	dir = 4
	},
/obj/effect/turf_decal/siding/wideplating_new/dark{
	dir = 8
	},
/obj/effect/turf_decal/siding/wood{
	dir = 4
	},
/obj/effect/turf_decal/siding/wood{
	dir = 8
	},
/obj/structure/railing{
	dir = 4;
	color = "#895129"
	},
/obj/structure/railing{
	dir = 8;
	color = "#895129"
	},
/turf/open/floor/wood/stairs/down,
/area/ruin/unpowered)
"Oe" = (
/obj/effect/turf_decal/siding/wideplating_new/dark{
	dir = 1
	},
/obj/effect/turf_decal/siding/wideplating_new/dark,
/obj/effect/turf_decal/siding/wood,
/obj/effect/turf_decal/siding/wood{
	dir = 1
	},
/obj/structure/railing{
	dir = 1;
	color = "#895129"
	},
/obj/structure/railing{
	dir = 2;
	color = "#895129"
	},
/turf/open/floor/wood/large,
/area/ruin/unpowered)
"PC" = (
/obj/structure/stone_tile/block{
	dir = 4
	},
/obj/structure/stone_tile{
	dir = 4
	},
/turf/open/water/jungle,
/area/ruin/unpowered)
"Qi" = (
/obj/structure/stone_tile/block/cracked,
/turf/open/water/jungle,
/area/ruin/unpowered)
"Qt" = (
/obj/structure/stone_tile/block{
	dir = 4
	},
/obj/structure/stone_tile{
	dir = 4
	},
/turf/open/misc/asteroid/basalt/lava_land_surface,
/area/lavaland/surface/outdoors)
"Qu" = (
/obj/item/flashlight/lantern/on,
/obj/item/food/grown/berries/blueberry{
	pixel_x = -3;
	pixel_y = 2
	},
/turf/open/floor/engine/cult{
	initial_gas_mix = "LAVALAND_ATMOS"
	},
/area/ruin/unpowered)
"Ta" = (
/obj/structure/stone_tile/surrounding/cracked{
	dir = 1
	},
/turf/open/water/jungle,
/area/ruin/unpowered)
"TE" = (
/obj/effect/turf_decal/siding/wideplating_new/dark{
	dir = 1
	},
/obj/effect/turf_decal/siding/wideplating_new/dark,
/obj/effect/turf_decal/siding/wood,
/obj/effect/turf_decal/siding/wood{
	dir = 1
	},
/obj/structure/railing{
	dir = 1;
	color = "#895129"
	},
/obj/structure/railing{
	dir = 2;
	color = "#895129"
	},
/obj/effect/decal/cleanable/blood/footprints{
	dir = 4;
	color = "0000FF"
	},
/turf/open/floor/wood/large,
/area/ruin/unpowered)
"TF" = (
/obj/structure/railing{
	dir = 1;
	color = "#895129"
	},
/obj/structure/railing{
	dir = 2;
	color = "#895129"
	},
/obj/effect/turf_decal/siding/wideplating_new/dark{
	dir = 1
	},
/obj/effect/turf_decal/siding/wood{
	dir = 1
	},
/obj/effect/turf_decal/siding/wideplating_new/dark,
/obj/effect/turf_decal/siding/wood,
/obj/effect/decal/cleanable/blood/drip{
	pixel_x = -3;
	pixel_y = 10;
	color = "0000FF"
	},
/turf/open/floor/wood/stairs/right,
/area/ruin/unpowered)
"Wc" = (
/obj/structure/table/wood/fancy/royalblue,
/obj/structure/statue/blueberry{
	pixel_x = 0;
	pixel_y = 19
	},
/obj/item/food/blueberry_gum{
	pixel_x = 0;
	pixel_y = -5
	},
/obj/item/reagent_containers/cup/beaker/blueberry_juice{
	pixel_x = 9;
	pixel_y = 5
	},
/obj/item/reagent_containers/cup/beaker/blueberry_juice{
	pixel_x = -7;
	pixel_y = 5
	},
/obj/effect/light_emitter/tendril,
/turf/open/floor/carpet/royalblue,
/area/ruin/unpowered)
"Wh" = (
/obj/effect/turf_decal/siding/wideplating_new/dark{
	dir = 4
	},
/obj/effect/turf_decal/siding/wideplating_new/dark{
	dir = 8
	},
/obj/effect/turf_decal/siding/wood{
	dir = 4
	},
/obj/effect/turf_decal/siding/wood{
	dir = 8
	},
/obj/structure/railing{
	dir = 4;
	color = "#895129"
	},
/obj/structure/railing{
	dir = 8;
	color = "#895129"
	},
/turf/open/floor/wood/stairs,
/area/ruin/unpowered)
"Wv" = (
/obj/structure/stone_tile/block{
	dir = 8
	},
/obj/structure/stone_tile{
	dir = 1
	},
/turf/open/misc/asteroid/basalt/lava_land_surface,
/area/lavaland/surface/outdoors)
"Yf" = (
/turf/template_noop,
/area/template_noop)
"YP" = (
/obj/structure/railing/corner/end{
	color = "#895129";
	dir = 8
	},
/obj/structure/railing/corner/end/flip{
	color = "#895129";
	dir = 8
	},
/turf/open/floor/engine/cult{
	initial_gas_mix = "LAVALAND_ATMOS"
	},
/area/ruin/unpowered)

(1,1,1) = {"
Yf
Yf
Yf
Yf
Yf
Yf
Yf
Yf
Yf
Yf
Yf
Yf
Yf
Yf
Yf
Yf
Yf
Yf
Yf
Yf
"}
(2,1,1) = {"
Yf
Yf
Yf
Yf
Yf
Yf
Yf
Yf
Yf
Yf
Yf
Yf
Yf
Yf
Yf
Yf
Yf
Yf
Yf
Yf
"}
(3,1,1) = {"
Yf
Yf
Yf
Yf
Yf
Yf
Yf
Yf
Yf
Yf
Yf
Yf
Yf
Yf
Yf
Cl
Cl
Cl
Yf
Yf
"}
(4,1,1) = {"
Yf
Yf
Yf
Yf
Yf
Yf
Yf
IZ
IZ
IZ
IZ
IZ
Cl
Cl
Cl
Cl
Cl
Cl
Cl
Yf
"}
(5,1,1) = {"
Yf
Yf
Yf
Yf
Cl
Cl
Cl
uj
Wv
my
tg
EN
Cl
Cl
Cl
Cl
Cl
Cl
Cl
Yf
"}
(6,1,1) = {"
Yf
Yf
Yf
Cl
Cl
Cl
Cl
Kf
lc
Kf
lc
Kf
Cl
Cl
Cl
Cl
Cl
Cl
Cl
Yf
"}
(7,1,1) = {"
Yf
Yf
Cl
Cl
Cl
Cl
Cl
Kf
AF
Ta
AF
Kf
Cl
Cl
Cl
Cl
Cl
Cl
Cl
Cl
"}
(8,1,1) = {"
Yf
Cl
Cl
Cl
Cl
Cl
Cl
Kf
AF
hx
AF
Kf
Cl
Cl
Cl
Cl
Cl
Cl
Cl
Cl
"}
(9,1,1) = {"
Yf
Cl
Cl
Cl
Cl
Cl
Kf
Kf
AF
Kf
AF
Kf
Kf
Cl
Cl
Cl
Cl
Cl
Cl
Cl
"}
(10,1,1) = {"
Cl
Cl
Cl
Cl
Kf
Kf
Kf
AF
AF
gJ
AF
AF
Kf
Kf
Kf
Cl
Cl
Cl
Cl
Cl
"}
(11,1,1) = {"
Cl
Cl
Cl
Kf
Kf
tf
EA
hN
yE
sq
vm
AF
AF
Jx
Kf
Kf
Cl
Cl
Cl
Cl
"}
(12,1,1) = {"
Cl
Cl
Cl
Kf
Qi
gJ
sa
Bl
Al
Je
JD
Bl
ol
gJ
gG
Kf
Cl
Cl
Cl
Cl
"}
(13,1,1) = {"
Cl
Cl
Kf
Kf
Qi
gJ
TE
gJ
gG
Kf
Qi
gJ
Oe
gJ
qL
Kf
Kf
Cl
Cl
Cl
"}
(14,1,1) = {"
Cl
Cl
Kf
aw
Ay
gJ
TF
am
cZ
Ff
Ay
JO
GS
gJ
cZ
aw
Kf
Cl
Cl
Cl
"}
(15,1,1) = {"
Cl
Cl
Kf
md
oJ
gJ
Jj
Ax
Mc
Mi
HK
Wh
Ik
gJ
hx
iK
Kf
Cl
Cl
Cl
"}
(16,1,1) = {"
Cl
Cl
Kf
Qu
Kf
gJ
gJ
gG
fd
Wc
wd
eh
gJ
gJ
Kf
ny
Kf
Cl
Cl
Cl
"}
(17,1,1) = {"
Cl
Cl
Kf
Ny
Ta
gJ
yt
NU
Gn
yf
sw
Wh
gt
gJ
Cp
gf
Kf
Cl
Cl
Cl
"}
(18,1,1) = {"
Cl
Cl
Kf
su
zb
gJ
bV
lK
KY
Je
zb
PC
bV
gJ
qe
aw
Kf
Cl
Cl
Cl
"}
(19,1,1) = {"
Cl
Cl
Kf
Kf
Qi
gJ
Oe
gJ
qL
Kf
eh
gJ
Oe
gJ
qL
Kf
Kf
Cl
Cl
Cl
"}
(20,1,1) = {"
Cl
Cl
Cl
Kf
eh
gJ
YP
Bl
yl
Aq
de
Bl
YP
gJ
gG
Kf
Cl
Cl
Cl
Cl
"}
(21,1,1) = {"
Cl
Cl
Cl
Kf
Kf
sr
AF
AF
yE
sq
vm
AF
AF
qe
Kf
Kf
Cl
Cl
Cl
Cl
"}
(22,1,1) = {"
Cl
Cl
Cl
Cl
Kf
Kf
Kf
AF
AF
gJ
AF
AF
Kf
Kf
Kf
Cl
Cl
Cl
Cl
Cl
"}
(23,1,1) = {"
Cl
Cl
Cl
Cl
Cl
Cl
Kf
Kf
AF
Kf
AF
Kf
Kf
Cl
Cl
Cl
Cl
Cl
Cl
Cl
"}
(24,1,1) = {"
Yf
Cl
Cl
Cl
Cl
Cl
Cl
Kf
AF
Cp
AF
Kf
Cl
Cl
Cl
Cl
Cl
Cl
Cl
Cl
"}
(25,1,1) = {"
Yf
Cl
Cl
Cl
Cl
Cl
Cl
Kf
AF
oJ
AF
Kf
Cl
Cl
Cl
Cl
Cl
Cl
Cl
Yf
"}
(26,1,1) = {"
Yf
Yf
Cl
Cl
Cl
Cl
Cl
Kf
lc
Kf
lc
Kf
Cl
Cl
Cl
Cl
Cl
Cl
Cl
Yf
"}
(27,1,1) = {"
Yf
Yf
Yf
Cl
Cl
Cl
Cl
LV
Qt
my
zp
gK
Cl
Cl
Cl
Cl
Cl
Cl
Yf
Yf
"}
(28,1,1) = {"
Yf
Yf
Yf
Yf
Yf
Yf
Yf
IZ
IZ
IZ
IZ
IZ
Yf
Yf
Yf
Yf
Yf
Yf
Yf
Yf
"}
(29,1,1) = {"
Yf
Yf
Yf
Yf
Yf
Yf
Yf
Yf
Yf
Yf
Yf
Yf
Yf
Yf
Yf
Yf
Yf
Yf
Yf
Yf
"}
(30,1,1) = {"
Yf
Yf
Yf
Yf
Yf
Yf
Yf
Yf
Yf
Yf
Yf
Yf
Yf
Yf
Yf
Yf
Yf
Yf
Yf
Yf
"}
