//MAP CONVERTED BY dmm2tgm.py THIS HEADER COMMENT PREVENTS RECONVERSION, DO NOT REMOVE
"a" = (
/turf/open/candyfloor,
/area/ruin/unpowered)
"c" = (
/mob/living/simple_animal/hostile/feed/chocolate_slime/creambeast,
/turf/open/indestructible/bubblegum,
/area/ruin/unpowered)
"e" = (
/mob/living/simple_animal/hostile/feed/chocolate_slime,
/turf/open/indestructible/bubblegum,
/area/ruin/unpowered)
"f" = (
/obj/effect/turf_decal/candy/bluewhite1,
/obj/effect/light_emitter/tendril,
/turf/open/candyfloor,
/area/ruin/unpowered)
"g" = (
/obj/structure/table/reinforced/plasmarglass,
/obj/item/food/pie/cream{
	pixel_x = -2;
	pixel_y = 5
	},
/turf/open/candyfloor,
/area/ruin/unpowered)
"h" = (
/obj/structure/table/reinforced/plasmarglass,
/obj/item/food/candy_corn{
	pixel_x = -15;
	pixel_y = -12
	},
/obj/item/food/candiedapple{
	pixel_x = 19;
	pixel_y = -15
	},
/obj/item/food/candied_pineapple{
	pixel_x = -20;
	pixel_y = 11
	},
/obj/item/food/cake/birthday{
	pixel_x = 0;
	pixel_y = 4
	},
/obj/effect/light_emitter/tendril,
/turf/open/candyfloor,
/area/ruin/unpowered)
"j" = (
/obj/structure/table/reinforced/plasmarglass,
/obj/item/food/ant_candy{
	pixel_x = 11;
	pixel_y = 2
	},
/turf/open/candyfloor,
/area/ruin/unpowered)
"l" = (
/obj/structure/table/reinforced/plasmarglass,
/obj/item/food/lollipop{
	pixel_x = -1;
	pixel_y = -9
	},
/obj/item/food/candied_pineapple{
	pixel_x = -1;
	pixel_y = 8
	},
/turf/open/candyfloor,
/area/ruin/unpowered)
"m" = (
/obj/structure/table/reinforced/plasmarglass,
/obj/item/food/lollipop{
	pixel_x = -10;
	pixel_y = 4
	},
/obj/item/food/swirl_lollipop{
	pixel_x = 2;
	pixel_y = 2
	},
/turf/open/candyfloor,
/area/ruin/unpowered)
"o" = (
/obj/structure/lollipop{
	icon_state = "lollipop_tree_red"
	},
/turf/open/indestructible/bubblegum,
/area/ruin/unpowered)
"p" = (
/obj/effect/turf_decal/candy/greenwhite2,
/turf/open/candyfloor,
/area/ruin/unpowered)
"r" = (
/turf/closed/indestructible/rock,
/area/lavaland/surface/outdoors)
"s" = (
/obj/item/food/candyheart,
/mob/living/simple_animal/hostile/feed/chocolate_slime,
/turf/open/indestructible/bubblegum,
/area/ruin/unpowered)
"t" = (
/obj/effect/turf_decal/candy/redwhite,
/turf/open/candyfloor,
/area/ruin/unpowered)
"u" = (
/turf/template_noop,
/area/template_noop)
"y" = (
/obj/structure/table/reinforced/plasmarglass,
/obj/item/food/candy_corn{
	pixel_x = -8;
	pixel_y = -6
	},
/obj/item/food/spiderlollipop,
/turf/open/candyfloor,
/area/ruin/unpowered)
"z" = (
/obj/effect/light_emitter/tendril,
/turf/open/indestructible/bubblegum,
/area/ruin/unpowered)
"A" = (
/turf/open/indestructible/bubblegum,
/area/ruin/unpowered)
"C" = (
/mob/living/simple_animal/hostile/feed/chocolate_slime/creambeast,
/turf/open/candyfloor,
/area/ruin/unpowered)
"D" = (
/obj/effect/turf_decal/candy/bluewhite1,
/turf/open/candyfloor,
/area/ruin/unpowered)
"E" = (
/obj/item/food/candyheart,
/turf/open/indestructible/bubblegum,
/area/ruin/unpowered)
"F" = (
/obj/structure/table/reinforced/plasmarglass,
/obj/item/food/lollipop,
/obj/item/food/lollipop{
	pixel_x = 1;
	pixel_y = 5
	},
/turf/open/candyfloor,
/area/ruin/unpowered)
"G" = (
/obj/effect/turf_decal/candy/purplewhite1,
/turf/open/candyfloor,
/area/ruin/unpowered)
"H" = (
/obj/effect/light_emitter/tendril,
/turf/open/candyfloor,
/area/ruin/unpowered)
"I" = (
/obj/structure/table/reinforced/plasmarglass,
/obj/item/food/candiedapple{
	pixel_x = 4;
	pixel_y = -2
	},
/turf/open/candyfloor,
/area/ruin/unpowered)
"J" = (
/obj/structure/table/reinforced/plasmarglass,
/obj/item/food/pie/grapetart{
	pixel_x = 0;
	pixel_y = 5
	},
/turf/open/candyfloor,
/area/ruin/unpowered)
"M" = (
/obj/effect/turf_decal/candy/redwhite,
/obj/effect/light_emitter/tendril,
/turf/open/candyfloor,
/area/ruin/unpowered)
"N" = (
/turf/closed/indestructible/candy,
/area/ruin/unpowered)
"O" = (
/obj/effect/turf_decal/candy/redwhite2,
/turf/open/candyfloor,
/area/ruin/unpowered)
"P" = (
/mob/living/simple_animal/hostile/feed/chocolate_slime,
/turf/open/candyfloor,
/area/ruin/unpowered)
"Q" = (
/obj/effect/turf_decal/candy/greenwhite1,
/turf/open/candyfloor,
/area/ruin/unpowered)
"U" = (
/obj/structure/lollipop,
/turf/open/indestructible/bubblegum,
/area/ruin/unpowered)
"W" = (
/obj/item/food/candyheart,
/obj/effect/light_emitter/tendril,
/turf/open/indestructible/bubblegum,
/area/ruin/unpowered)
"Y" = (
/turf/open/misc/asteroid/basalt/lava_land_surface,
/area/lavaland/surface/outdoors)
"Z" = (
/obj/structure/fans/tiny/invisible,
/obj/structure/mineral_door/sandstone,
/turf/open/indestructible/bubblegum,
/area/ruin/unpowered)

(1,1,1) = {"
u
u
u
u
u
u
u
u
u
u
u
u
u
u
u
u
u
u
u
u
"}
(2,1,1) = {"
u
u
u
u
u
r
r
r
Y
Y
Y
r
r
r
u
u
u
u
u
u
"}
(3,1,1) = {"
u
u
u
r
r
r
r
r
Y
Y
Y
r
r
r
r
r
u
u
u
u
"}
(4,1,1) = {"
u
r
r
r
r
r
N
N
N
Z
N
N
N
r
r
r
u
u
u
u
"}
(5,1,1) = {"
r
r
r
r
N
N
N
t
a
a
a
a
N
N
N
r
r
r
u
u
"}
(6,1,1) = {"
r
r
r
N
N
A
o
a
a
o
a
O
a
a
N
N
r
r
u
u
"}
(7,1,1) = {"
r
r
r
N
A
W
e
E
a
H
p
a
a
f
a
N
r
r
r
u
"}
(8,1,1) = {"
r
r
N
N
E
A
A
o
G
a
a
E
U
a
O
N
N
r
r
u
"}
(9,1,1) = {"
u
r
N
a
Q
U
E
a
P
p
a
c
E
a
a
a
N
r
r
u
"}
(10,1,1) = {"
Y
Y
N
O
a
a
C
D
j
l
J
O
G
a
A
a
N
Y
Y
u
"}
(11,1,1) = {"
Y
Y
Z
a
U
H
G
a
I
h
m
a
a
M
a
a
Z
Y
Y
u
"}
(12,1,1) = {"
Y
Y
N
a
a
a
o
E
y
g
F
a
e
E
A
Q
N
Y
Y
u
"}
(13,1,1) = {"
u
r
N
D
a
E
A
A
E
C
p
A
E
A
U
A
N
r
r
u
"}
(14,1,1) = {"
u
r
N
N
a
U
s
A
A
a
G
A
o
A
A
N
N
r
r
u
"}
(15,1,1) = {"
u
r
r
N
p
H
A
o
a
H
a
E
A
z
E
N
r
r
r
u
"}
(16,1,1) = {"
u
r
r
N
N
a
a
a
a
U
a
t
A
o
N
N
r
r
u
u
"}
(17,1,1) = {"
u
r
r
r
N
N
N
O
a
a
D
a
N
N
N
r
r
u
u
u
"}
(18,1,1) = {"
u
u
r
r
r
r
N
N
N
Z
N
N
N
r
r
r
r
u
u
u
"}
(19,1,1) = {"
u
u
u
r
r
r
r
r
Y
Y
Y
r
r
r
r
r
u
u
u
u
"}
(20,1,1) = {"
u
u
u
u
u
r
r
r
Y
Y
Y
r
r
u
u
u
u
u
u
u
"}
