//MAP CONVERTED BY dmm2tgm.py THIS HEADER COMMENT PREVENTS RECONVERSION, DO NOT REMOVE
"am" = (
/obj/structure/fans/tiny/invisible,
/obj/structure/mineral_door/calorite,
/turf/open/floor/mineral/calorite,
/area/ruin/unpowered)
"aw" = (
/obj/effect/turf_decal/tile/dark_red/diagonal_edge,
/obj/effect/turf_decal/tile/brown/diagonal_centre,
/obj/effect/turf_decal/siding/wideplating_new/terracotta{
	dir = 8
	},
/obj/effect/turf_decal/siding/wideplating_new/terracotta/corner,
/turf/open/floor/iron/diagonal,
/area/ruin/unpowered)
"bV" = (
/obj/effect/turf_decal/siding/wideplating_new/terracotta{
	dir = 8
	},
/turf/open/floor/mineral/calorite,
/area/ruin/unpowered)
"cZ" = (
/obj/structure/window/calorite/unanchored/spawner/directional/east,
/obj/structure/window/calorite/spawner/directional/south,
/obj/structure/statue/calorite/fatty,
/turf/open/floor/mineral/calorite/strong,
/area/ruin/unpowered)
"de" = (
/obj/structure/table/wood/fancy/orange,
/obj/effect/turf_decal/tile/dark_red/diagonal_edge,
/obj/effect/turf_decal/tile/brown/diagonal_centre,
/obj/item/food/donut/jelly/slimejelly/blumpkin{
	pixel_x = 9;
	pixel_y = -2
	},
/obj/item/food/donut/jelly/slimejelly/berry{
	pixel_x = 4;
	pixel_y = 3
	},
/obj/item/food/donut/jelly/slimejelly/apple{
	pixel_x = -1;
	pixel_y = 8
	},
/obj/item/food/donut/jelly/slimejelly/bungo{
	pixel_x = -7;
	pixel_y = 12
	},
/obj/effect/turf_decal/siding/wideplating_new/terracotta{
	dir = 5
	},
/turf/open/floor/iron/diagonal,
/area/ruin/unpowered)
"eh" = (
/obj/effect/turf_decal/tile/dark_red/diagonal_edge,
/obj/effect/turf_decal/tile/brown/diagonal_centre,
/obj/effect/turf_decal/siding/wideplating_new/terracotta/corner{
	dir = 4
	},
/turf/open/floor/iron/diagonal,
/area/ruin/unpowered)
"fd" = (
/obj/effect/decal/bigfatsigil{
	pixel_x = -32;
	pixel_y = -46
	},
/turf/open/floor/carpet/orange,
/area/ruin/unpowered)
"gf" = (
/obj/structure/chair/sofa/right/brown{
	dir = 1
	},
/obj/structure/trap/fattening,
/turf/open/floor/carpet/orange,
/area/ruin/unpowered)
"gt" = (
/obj/item/flashlight/lantern/on,
/obj/structure/stone_tile/slab,
/turf/open/misc/asteroid/basalt/lava_land_surface,
/area/lavaland/surface/outdoors)
"gJ" = (
/obj/structure/statue/calorite/pillar,
/turf/open/floor/carpet/orange,
/area/ruin/unpowered)
"gK" = (
/obj/effect/turf_decal/tile/dark_red/diagonal_edge,
/obj/effect/turf_decal/tile/brown/diagonal_centre,
/obj/effect/turf_decal/siding/wideplating_new/terracotta/corner,
/turf/open/floor/iron/diagonal,
/area/ruin/unpowered)
"hx" = (
/obj/item/food/burger/greaseburger{
	pixel_x = 10;
	pixel_y = 17
	},
/obj/structure/table/wood/fancy/orange,
/obj/item/food/burger/superbite{
	pixel_x = -6;
	pixel_y = 3
	},
/turf/open/floor/carpet/orange,
/area/ruin/unpowered)
"hN" = (
/obj/structure/table/wood/fancy/orange,
/obj/item/melee/curator_whip/fattening,
/obj/item/reagent_containers/cup/beaker/micro_calorite{
	pixel_x = 0;
	pixel_y = 5
	},
/turf/open/floor/mineral/calorite/dance,
/area/ruin/unpowered)
"iK" = (
/obj/structure/chair/sofa/left/brown{
	dir = 1
	},
/obj/structure/trap/fattening,
/turf/open/floor/carpet/orange,
/area/ruin/unpowered)
"lc" = (
/obj/effect/turf_decal/tile/dark_red/diagonal_edge,
/obj/effect/turf_decal/tile/brown/diagonal_centre,
/obj/effect/turf_decal/siding/wideplating_new/terracotta{
	dir = 1
	},
/obj/effect/turf_decal/siding/wideplating_new/terracotta/corner,
/turf/open/floor/iron/diagonal,
/area/ruin/unpowered)
"lK" = (
/obj/structure/window/calorite/spawner/directional/west,
/obj/item/stack/ore/calorite,
/turf/open/floor/mineral/calorite/strong,
/area/ruin/unpowered)
"md" = (
/obj/effect/turf_decal/tile/dark_red/diagonal_edge,
/obj/effect/turf_decal/tile/brown/diagonal_centre,
/obj/effect/turf_decal/siding/wideplating_new/terracotta{
	dir = 1
	},
/turf/open/floor/iron/diagonal,
/area/ruin/unpowered)
"ny" = (
/obj/structure/chair/sofa/middle/brown{
	dir = 1
	},
/obj/structure/trap/fattening,
/turf/open/floor/carpet/orange,
/area/ruin/unpowered)
"qe" = (
/obj/effect/turf_decal/tile/dark_red/diagonal_edge,
/obj/effect/turf_decal/tile/brown/diagonal_centre,
/obj/effect/turf_decal/siding/wideplating_new/terracotta{
	dir = 1
	},
/obj/effect/turf_decal/siding/wideplating_new/terracotta,
/turf/open/floor/iron/diagonal,
/area/ruin/unpowered)
"qL" = (
/obj/effect/turf_decal/tile/dark_red/diagonal_edge,
/obj/effect/turf_decal/tile/brown/diagonal_centre,
/obj/effect/turf_decal/siding/wideplating_new/terracotta/corner{
	dir = 8
	},
/turf/open/floor/iron/diagonal,
/area/ruin/unpowered)
"sr" = (
/obj/structure/window/calorite/unanchored/spawner/directional/east,
/obj/structure/statue/calorite/fatty,
/turf/open/floor/mineral/calorite/strong,
/area/ruin/unpowered)
"sw" = (
/obj/effect/turf_decal/tile/dark_red/diagonal_edge,
/obj/effect/turf_decal/tile/brown/diagonal_centre,
/obj/effect/turf_decal/siding/wideplating_new/terracotta{
	dir = 4
	},
/obj/effect/turf_decal/siding/wideplating_new/terracotta/corner{
	dir = 8
	},
/turf/open/floor/iron/diagonal,
/area/ruin/unpowered)
"tg" = (
/obj/structure/stone_tile/block{
	dir = 8
	},
/obj/structure/stone_tile,
/turf/open/misc/asteroid/basalt/lava_land_surface,
/area/lavaland/surface/outdoors)
"uj" = (
/obj/effect/turf_decal/tile/dark_red/diagonal_edge,
/obj/effect/turf_decal/tile/brown/diagonal_centre,
/obj/effect/turf_decal/siding/wideplating_new/terracotta{
	dir = 6
	},
/obj/effect/turf_decal/siding/wideplating_new/terracotta/corner{
	dir = 1
	},
/turf/open/floor/iron/diagonal,
/area/ruin/unpowered)
"vm" = (
/obj/structure/statue/calorite/pillar,
/turf/open/floor/mineral/calorite,
/area/ruin/unpowered)
"wd" = (
/obj/effect/light_emitter/tendril,
/turf/open/floor/carpet/orange,
/area/ruin/unpowered)
"yf" = (
/turf/open/floor/carpet/orange,
/area/ruin/unpowered)
"yl" = (
/obj/effect/turf_decal/tile/dark_red/diagonal_edge,
/obj/effect/turf_decal/tile/brown/diagonal_centre,
/obj/effect/turf_decal/siding/wideplating_new/terracotta/end{
	dir = 4
	},
/turf/open/floor/iron/diagonal,
/area/ruin/unpowered)
"yE" = (
/obj/effect/turf_decal/tile/dark_red/diagonal_edge,
/obj/effect/turf_decal/tile/brown/diagonal_centre,
/obj/effect/turf_decal/siding/wideplating_new/terracotta/end{
	dir = 8
	},
/turf/open/floor/iron/diagonal,
/area/ruin/unpowered)
"zb" = (
/obj/effect/turf_decal/tile/dark_red/diagonal_edge,
/obj/effect/turf_decal/tile/brown/diagonal_centre,
/obj/effect/turf_decal/siding/wideplating_new/terracotta{
	dir = 8
	},
/turf/open/floor/iron/diagonal,
/area/ruin/unpowered)
"zp" = (
/obj/structure/stone_tile/block{
	dir = 4
	},
/obj/structure/stone_tile{
	dir = 8
	},
/turf/open/misc/asteroid/basalt/lava_land_surface,
/area/lavaland/surface/outdoors)
"Al" = (
/obj/effect/turf_decal/tile/dark_red/diagonal_edge,
/obj/effect/turf_decal/tile/brown/diagonal_centre,
/obj/effect/turf_decal/siding/wideplating_new/terracotta,
/obj/effect/turf_decal/siding/wideplating_new/terracotta/corner{
	dir = 4
	},
/turf/open/floor/iron/diagonal,
/area/ruin/unpowered)
"Ax" = (
/obj/effect/turf_decal/tile/dark_red/diagonal_edge,
/obj/effect/turf_decal/tile/brown/diagonal_centre,
/obj/effect/turf_decal/siding/wideplating_new/terracotta{
	dir = 4
	},
/turf/open/floor/iron/diagonal,
/area/ruin/unpowered)
"Ay" = (
/turf/closed/wall/mineral/calorite,
/area/ruin/unpowered)
"AF" = (
/obj/structure/trap/fattening,
/obj/effect/light_emitter/tendril,
/turf/open/floor/mineral/calorite,
/area/ruin/unpowered)
"Bl" = (
/obj/effect/turf_decal/tile/dark_red/diagonal_edge,
/obj/effect/turf_decal/tile/brown/diagonal_centre,
/obj/effect/turf_decal/siding/wideplating_new/terracotta,
/obj/effect/turf_decal/siding/wideplating_new/terracotta/corner{
	dir = 1
	},
/turf/open/floor/iron/diagonal,
/area/ruin/unpowered)
"Cl" = (
/turf/closed/mineral/volcanic/lava_land_surface,
/area/lavaland/surface/outdoors)
"Cp" = (
/obj/structure/table/wood/fancy/orange,
/obj/item/food/burger/greaseburger{
	pixel_x = 6;
	pixel_y = 13
	},
/obj/item/food/burger/greaseburger{
	pixel_x = -8;
	pixel_y = 6
	},
/turf/open/floor/carpet/orange,
/area/ruin/unpowered)
"Ff" = (
/obj/effect/turf_decal/tile/dark_red/diagonal_edge,
/obj/effect/turf_decal/tile/brown/diagonal_centre,
/obj/effect/turf_decal/siding/wideplating_new/terracotta{
	dir = 5
	},
/turf/open/floor/iron/diagonal,
/area/ruin/unpowered)
"Gn" = (
/obj/structure/table/wood/fancy/orange,
/obj/item/food/burger/greaseburger{
	pixel_x = 9;
	pixel_y = 16
	},
/obj/item/food/burger/superbite{
	pixel_x = -7;
	pixel_y = 2
	},
/turf/open/floor/carpet/orange,
/area/ruin/unpowered)
"GS" = (
/obj/effect/turf_decal/siding/wideplating_new/terracotta{
	dir = 4
	},
/turf/open/floor/mineral/calorite,
/area/ruin/unpowered)
"HK" = (
/obj/effect/turf_decal/tile/dark_red/diagonal_edge,
/obj/effect/turf_decal/tile/brown/diagonal_centre,
/obj/effect/turf_decal/siding/wideplating_new/terracotta,
/turf/open/floor/iron/diagonal,
/area/ruin/unpowered)
"IZ" = (
/turf/open/misc/asteroid/basalt/lava_land_surface,
/area/lavaland/surface/outdoors)
"Je" = (
/obj/effect/turf_decal/tile/dark_red/diagonal_edge,
/obj/effect/turf_decal/tile/brown/diagonal_centre,
/obj/effect/turf_decal/siding/wideplating_new/terracotta{
	dir = 9
	},
/turf/open/floor/iron/diagonal,
/area/ruin/unpowered)
"Jj" = (
/obj/effect/gluttony,
/turf/open/floor/mineral/calorite/dance,
/area/ruin/unpowered)
"JD" = (
/obj/structure/table/wood/fancy/orange,
/obj/effect/turf_decal/tile/dark_red/diagonal_edge,
/obj/effect/turf_decal/tile/brown/diagonal_centre,
/obj/item/food/donut/jelly/slimejelly/blumpkin{
	pixel_x = -8;
	pixel_y = -2
	},
/obj/item/food/donut/jelly/slimejelly/berry{
	pixel_x = -3;
	pixel_y = 3
	},
/obj/item/food/donut/jelly/slimejelly/apple{
	pixel_x = 3;
	pixel_y = 8
	},
/obj/item/food/donut/jelly/slimejelly/bungo{
	pixel_x = 8;
	pixel_y = 12
	},
/obj/effect/turf_decal/siding/wideplating_new/terracotta{
	dir = 9
	},
/turf/open/floor/iron/diagonal,
/area/ruin/unpowered)
"JO" = (
/obj/effect/turf_decal/tile/dark_red/diagonal_edge,
/obj/effect/turf_decal/tile/brown/diagonal_centre,
/obj/effect/turf_decal/siding/wideplating_new/terracotta{
	dir = 6
	},
/turf/open/floor/iron/diagonal,
/area/ruin/unpowered)
"Kf" = (
/obj/effect/turf_decal/tile/dark_red/diagonal_edge,
/obj/effect/turf_decal/tile/brown/diagonal_centre,
/obj/effect/turf_decal/siding/wideplating_new/terracotta{
	dir = 10
	},
/obj/effect/turf_decal/siding/wideplating_new/terracotta/corner{
	dir = 4
	},
/turf/open/floor/iron/diagonal,
/area/ruin/unpowered)
"KY" = (
/obj/structure/window/calorite/spawner/directional/west,
/obj/structure/window/calorite/spawner/directional/south,
/obj/structure/statue/calorite/fatty,
/turf/open/floor/mineral/calorite/strong,
/area/ruin/unpowered)
"PC" = (
/obj/effect/turf_decal/tile/dark_red/diagonal_edge,
/obj/effect/turf_decal/tile/brown/diagonal_centre,
/obj/effect/turf_decal/siding/wideplating_new/terracotta{
	dir = 10
	},
/turf/open/floor/iron/diagonal,
/area/ruin/unpowered)
"Qi" = (
/obj/effect/turf_decal/tile/dark_red/diagonal_edge,
/obj/effect/turf_decal/tile/brown/diagonal_centre,
/obj/effect/turf_decal/siding/wideplating_new/terracotta/corner{
	dir = 1
	},
/turf/open/floor/iron/diagonal,
/area/ruin/unpowered)
"Qt" = (
/obj/structure/stone_tile/block{
	dir = 4
	},
/obj/structure/stone_tile{
	dir = 4
	},
/turf/open/misc/asteroid/basalt/lava_land_surface,
/area/lavaland/surface/outdoors)
"Qu" = (
/obj/effect/turf_decal/tile/dark_red/diagonal_edge,
/obj/effect/turf_decal/tile/brown/diagonal_centre,
/obj/effect/turf_decal/siding/wideplating_new/terracotta,
/obj/effect/turf_decal/siding/wideplating_new/terracotta{
	dir = 1
	},
/turf/open/floor/iron/diagonal,
/area/ruin/unpowered)
"Ta" = (
/obj/structure/statue/calorite/fatty/fattha,
/obj/effect/light_emitter/tendril,
/turf/open/floor/mineral/calorite/dance,
/area/ruin/unpowered)
"TE" = (
/obj/structure/window/calorite/spawner/directional/west,
/obj/structure/statue/calorite/fatty,
/turf/open/floor/mineral/calorite/strong,
/area/ruin/unpowered)
"TF" = (
/obj/structure/window/calorite/unanchored/spawner/directional/east,
/obj/item/stack/ore/calorite,
/turf/open/floor/mineral/calorite/strong,
/area/ruin/unpowered)
"Wh" = (
/obj/effect/turf_decal/tile/dark_red/diagonal_edge,
/obj/effect/turf_decal/tile/brown/diagonal_centre,
/obj/effect/turf_decal/siding/wideplating_new/terracotta{
	dir = 1
	},
/obj/effect/turf_decal/siding/wideplating_new/terracotta/corner{
	dir = 8
	},
/turf/open/floor/iron/diagonal,
/area/ruin/unpowered)
"Wv" = (
/obj/structure/stone_tile/block{
	dir = 8
	},
/obj/structure/stone_tile{
	dir = 1
	},
/turf/open/misc/asteroid/basalt/lava_land_surface,
/area/lavaland/surface/outdoors)
"Yf" = (
/turf/template_noop,
/area/template_noop)
"YP" = (
/turf/open/floor/mineral/calorite,
/area/ruin/unpowered)

(1,1,1) = {"
Yf
Yf
Yf
Yf
Yf
Yf
Yf
Yf
Yf
Yf
Yf
Yf
Yf
Yf
Yf
Yf
Yf
Yf
Yf
Yf
"}
(2,1,1) = {"
Yf
Yf
Yf
Yf
Yf
Yf
Yf
Yf
Yf
Yf
Yf
Yf
Yf
Yf
Yf
Yf
Yf
Yf
Yf
Yf
"}
(3,1,1) = {"
Yf
Yf
Yf
Yf
Yf
Yf
Yf
Yf
Yf
Yf
Yf
IZ
IZ
IZ
Yf
Yf
Yf
Yf
Yf
Yf
"}
(4,1,1) = {"
Yf
Yf
Yf
Yf
Yf
Yf
Yf
Yf
Yf
Yf
IZ
IZ
IZ
IZ
IZ
Yf
Yf
Yf
Yf
Yf
"}
(5,1,1) = {"
Yf
Yf
Yf
Yf
Yf
Yf
Yf
Yf
Yf
Yf
IZ
IZ
IZ
IZ
IZ
Yf
Yf
Yf
Yf
Yf
"}
(6,1,1) = {"
Yf
Yf
Yf
Yf
Yf
Yf
Yf
Yf
Yf
Yf
IZ
Wv
gt
tg
IZ
Yf
Yf
Yf
Yf
Yf
"}
(7,1,1) = {"
Yf
Yf
Yf
Yf
Yf
Yf
Yf
Yf
Cl
Cl
Ay
am
Ay
am
Ay
Cl
Yf
Yf
Yf
Yf
"}
(8,1,1) = {"
Yf
Yf
Yf
Yf
Yf
Yf
Yf
Cl
Cl
Cl
Ay
yE
vm
yE
Ay
Cl
Cl
Yf
Yf
Yf
"}
(9,1,1) = {"
Yf
Yf
Yf
Yf
Yf
Yf
Yf
Cl
Cl
Cl
Ay
qe
AF
qe
Ay
Cl
Cl
Yf
Yf
Yf
"}
(10,1,1) = {"
Yf
Yf
Cl
Cl
Cl
Cl
Cl
Cl
Cl
Cl
Ay
qe
vm
qe
Ay
Cl
Cl
Cl
Yf
Yf
"}
(11,1,1) = {"
Yf
Cl
Cl
Cl
Cl
Cl
Cl
Cl
Cl
Ay
Ay
qe
Ay
qe
Ay
Ay
Cl
Cl
Cl
Yf
"}
(12,1,1) = {"
Cl
Cl
Cl
Cl
Cl
Cl
Cl
Cl
Ay
Ay
JD
Bl
YP
Wh
PC
Ay
Ay
Cl
Cl
Cl
"}
(13,1,1) = {"
Cl
Cl
Cl
Cl
Ay
Ay
Ay
Ay
Ay
JD
Qi
HK
YP
md
qL
PC
Ay
Ay
Cl
Cl
"}
(14,1,1) = {"
Cl
Cl
Ay
Ay
Ay
sr
TF
TF
cZ
Ff
Ax
JO
GS
Ff
Ax
sw
Kf
Ay
Cl
Cl
"}
(15,1,1) = {"
Cl
Cl
Ay
Jj
Jj
Jj
Jj
gJ
yf
yf
gJ
yf
yf
gJ
hx
iK
Qu
Ay
Cl
Cl
"}
(16,1,1) = {"
Cl
Cl
Ay
Jj
Ta
hN
Jj
wd
fd
yf
wd
yf
yf
wd
Gn
ny
Qu
Ay
Cl
Cl
"}
(17,1,1) = {"
Cl
Cl
Ay
Jj
Jj
Jj
Jj
gJ
yf
yf
gJ
yf
yf
gJ
Cp
gf
Qu
Ay
Cl
Cl
"}
(18,1,1) = {"
Cl
Cl
Ay
Ay
Ay
TE
lK
lK
KY
Je
zb
PC
bV
Je
zb
aw
uj
Ay
Cl
Cl
"}
(19,1,1) = {"
Cl
Cl
Cl
Cl
Ay
Ay
Ay
Ay
Ay
de
eh
HK
YP
md
gK
JO
Ay
Ay
Cl
Cl
"}
(20,1,1) = {"
Cl
Cl
Cl
Cl
Cl
Cl
Cl
Cl
Ay
Ay
de
Al
YP
lc
JO
Ay
Ay
Cl
Cl
Cl
"}
(21,1,1) = {"
Yf
Cl
Cl
Cl
Cl
Cl
Cl
Cl
Cl
Ay
Ay
qe
Ay
qe
Ay
Ay
Cl
Cl
Cl
Yf
"}
(22,1,1) = {"
Yf
Yf
Cl
Cl
Cl
Cl
Cl
Cl
Cl
Cl
Ay
qe
vm
qe
Ay
Cl
Cl
Cl
Yf
Yf
"}
(23,1,1) = {"
Yf
Yf
Yf
Yf
Yf
Yf
Yf
Cl
Cl
Cl
Ay
qe
AF
qe
Ay
Cl
Cl
Yf
Yf
Yf
"}
(24,1,1) = {"
Yf
Yf
Yf
Yf
Yf
Yf
Yf
Cl
Cl
Cl
Ay
yl
vm
yl
Ay
Cl
Cl
Yf
Yf
Yf
"}
(25,1,1) = {"
Yf
Yf
Yf
Yf
Yf
Yf
Yf
Yf
Cl
Cl
Ay
am
Ay
am
Ay
Cl
Yf
Yf
Yf
Yf
"}
(26,1,1) = {"
Yf
Yf
Yf
Yf
Yf
Yf
Yf
Yf
Yf
Yf
IZ
Qt
gt
zp
IZ
Yf
Yf
Yf
Yf
Yf
"}
(27,1,1) = {"
Yf
Yf
Yf
Yf
Yf
Yf
Yf
Yf
Yf
Yf
IZ
IZ
IZ
IZ
IZ
Yf
Yf
Yf
Yf
Yf
"}
(28,1,1) = {"
Yf
Yf
Yf
Yf
Yf
Yf
Yf
Yf
Yf
Yf
IZ
IZ
IZ
IZ
IZ
Yf
Yf
Yf
Yf
Yf
"}
(29,1,1) = {"
Yf
Yf
Yf
Yf
Yf
Yf
Yf
Yf
Yf
Yf
Yf
IZ
IZ
IZ
Yf
Yf
Yf
Yf
Yf
Yf
"}
(30,1,1) = {"
Yf
Yf
Yf
Yf
Yf
Yf
Yf
Yf
Yf
Yf
Yf
Yf
Yf
Yf
Yf
Yf
Yf
Yf
Yf
Yf
"}
