//MAP CONVERTED BY dmm2tgm.py THIS HEADER COMMENT PREVENTS RECONVERSION, DO NOT REMOVE
"am" = (
/obj/structure/fans/tiny/invisible,
/obj/structure/mineral_door/calorite,
/turf/open/floor/mineral/calorite,
/area/ruin/unpowered)
"aw" = (
/turf/closed/wall/mineral/wood,
/area/ruin/unpowered)
"ft" = (
/obj/effect/turf_decal/tile/dark_red/diagonal_edge,
/obj/effect/turf_decal/tile/brown/diagonal_centre,
/obj/effect/turf_decal/siding/wideplating_new/terracotta{
	dir = 5
	},
/obj/structure/table/wood/fancy/orange,
/obj/item/stack/sheet/mineral/calorite/five,
/turf/open/floor/iron/diagonal,
/area/ruin/unpowered)
"fz" = (
/obj/effect/turf_decal/tile/dark_red/diagonal_edge,
/obj/effect/turf_decal/tile/brown/diagonal_centre,
/obj/effect/turf_decal/siding/wideplating_new/terracotta{
	dir = 1
	},
/obj/structure/trap/belch,
/turf/open/floor/iron/diagonal,
/area/ruin/unpowered)
"gm" = (
/obj/effect/turf_decal/tile/dark_red/diagonal_edge,
/obj/effect/turf_decal/tile/brown/diagonal_centre,
/obj/effect/turf_decal/siding/wideplating_new/terracotta/corner{
	dir = 8
	},
/obj/effect/light_emitter/tendril,
/obj/structure/trap/fattening,
/turf/open/floor/iron/diagonal,
/area/ruin/unpowered)
"gt" = (
/obj/item/flashlight/lantern/on{
	pixel_x = 4;
	pixel_y = 1
	},
/obj/item/storage/belt/mining/vendor{
	pixel_x = -19;
	pixel_y = 7
	},
/turf/open/misc/asteroid/basalt/lava_land_surface,
/area/lavaland/surface/outdoors)
"hE" = (
/obj/effect/turf_decal/tile/dark_red/diagonal_edge,
/obj/effect/turf_decal/tile/brown/diagonal_centre,
/obj/effect/turf_decal/siding/wideplating_new/terracotta{
	dir = 4
	},
/turf/open/floor/iron/diagonal,
/area/ruin/unpowered)
"hQ" = (
/obj/effect/turf_decal/tile/dark_red/diagonal_edge,
/obj/effect/turf_decal/tile/brown/diagonal_centre,
/obj/effect/turf_decal/siding/wideplating_new/terracotta{
	dir = 9
	},
/obj/structure/trap/fattening,
/turf/open/floor/iron/diagonal,
/area/ruin/unpowered)
"jI" = (
/obj/structure/window/calorite/spawner/directional/north,
/obj/effect/turf_decal/siding/wideplating_new/terracotta{
	dir = 1
	},
/mob/living/simple_animal/hostile/fatten/magehand,
/turf/open/floor/mineral/calorite,
/area/ruin/unpowered)
"jQ" = (
/obj/effect/turf_decal/tile/dark_red/diagonal_edge,
/obj/effect/turf_decal/tile/brown/diagonal_centre,
/obj/effect/turf_decal/siding/wideplating_new/terracotta,
/obj/structure/trap/fattening,
/turf/open/floor/iron/diagonal,
/area/ruin/unpowered)
"li" = (
/mob/living/simple_animal/hostile/fatten/magehand,
/turf/open/floor/mineral/calorite,
/area/ruin/unpowered)
"lv" = (
/obj/effect/turf_decal/tile/dark_red/diagonal_edge,
/obj/effect/turf_decal/tile/brown/diagonal_centre,
/obj/effect/turf_decal/siding/wideplating_new/terracotta/corner{
	dir = 4
	},
/obj/effect/light_emitter/tendril,
/turf/open/floor/iron/diagonal,
/area/ruin/unpowered)
"nm" = (
/obj/effect/turf_decal/tile/dark_red/diagonal_edge,
/obj/effect/turf_decal/tile/brown/diagonal_centre,
/obj/effect/turf_decal/siding/wideplating_new/terracotta{
	dir = 6
	},
/obj/structure/statue/calorite/pillar,
/turf/open/floor/iron/diagonal,
/area/ruin/unpowered)
"oV" = (
/obj/effect/turf_decal/tile/dark_red/diagonal_edge,
/obj/effect/turf_decal/tile/brown/diagonal_centre,
/obj/effect/turf_decal/siding/wideplating_new/terracotta{
	dir = 6
	},
/obj/structure/trap/fattening,
/turf/open/floor/iron/diagonal,
/area/ruin/unpowered)
"qQ" = (
/obj/effect/turf_decal/tile/dark_red/diagonal_edge,
/obj/effect/turf_decal/tile/brown/diagonal_centre,
/obj/effect/turf_decal/siding/wideplating_new/terracotta{
	dir = 5
	},
/obj/structure/trap/fattening,
/turf/open/floor/iron/diagonal,
/area/ruin/unpowered)
"rn" = (
/obj/effect/turf_decal/tile/dark_red/diagonal_edge,
/obj/effect/turf_decal/tile/brown/diagonal_centre,
/obj/effect/turf_decal/siding/wideplating_new/terracotta/corner{
	dir = 8
	},
/obj/structure/trap/fattening,
/turf/open/floor/iron/diagonal,
/area/ruin/unpowered)
"ru" = (
/obj/effect/turf_decal/tile/dark_red/diagonal_edge,
/obj/effect/turf_decal/tile/brown/diagonal_centre,
/obj/effect/turf_decal/siding/wideplating_new/terracotta{
	dir = 9
	},
/turf/open/floor/iron/diagonal,
/area/ruin/unpowered)
"ry" = (
/obj/effect/turf_decal/tile/dark_red/diagonal_edge,
/obj/effect/turf_decal/tile/brown/diagonal_centre,
/turf/open/floor/iron/diagonal,
/area/ruin/unpowered)
"se" = (
/obj/effect/turf_decal/tile/dark_red/diagonal_edge,
/obj/effect/turf_decal/tile/brown/diagonal_centre,
/obj/effect/turf_decal/siding/wideplating_new/terracotta/corner,
/obj/structure/trap/fattening,
/turf/open/floor/iron/diagonal,
/area/ruin/unpowered)
"vK" = (
/obj/effect/turf_decal/tile/dark_red/diagonal_edge,
/obj/effect/turf_decal/tile/brown/diagonal_centre,
/obj/effect/turf_decal/siding/wideplating_new/terracotta{
	dir = 5
	},
/turf/open/floor/iron/diagonal,
/area/ruin/unpowered)
"wW" = (
/obj/effect/turf_decal/tile/dark_red/diagonal_edge,
/obj/effect/turf_decal/tile/brown/diagonal_centre,
/obj/effect/turf_decal/siding/wideplating_new/terracotta{
	dir = 6
	},
/obj/structure/trap/belch,
/turf/open/floor/iron/diagonal,
/area/ruin/unpowered)
"xl" = (
/obj/structure/window/calorite/spawner/directional/west,
/obj/effect/turf_decal/siding/wideplating_new/terracotta{
	dir = 8
	},
/mob/living/simple_animal/hostile/fatten/magehand,
/turf/open/floor/mineral/calorite,
/area/ruin/unpowered)
"xQ" = (
/obj/effect/turf_decal/tile/dark_red/diagonal_edge,
/obj/effect/turf_decal/tile/brown/diagonal_centre,
/obj/effect/turf_decal/siding/wideplating_new/terracotta{
	dir = 5
	},
/obj/structure/table/wood/fancy/orange,
/obj/item/grenade/chem_grenade/lipoifier{
	pixel_x = 0;
	pixel_y = 5
	},
/turf/open/floor/iron/diagonal,
/area/ruin/unpowered)
"xX" = (
/obj/effect/turf_decal/tile/dark_red/diagonal_edge,
/obj/effect/turf_decal/tile/brown/diagonal_centre,
/obj/effect/turf_decal/siding/wideplating_new/terracotta{
	dir = 9
	},
/obj/structure/trap/belch,
/turf/open/floor/iron/diagonal,
/area/ruin/unpowered)
"zP" = (
/obj/structure/window/calorite/fulltile,
/turf/open/floor/mineral/calorite,
/area/ruin/unpowered)
"Ag" = (
/obj/effect/turf_decal/tile/dark_red/diagonal_edge,
/obj/effect/turf_decal/tile/brown/diagonal_centre,
/obj/effect/turf_decal/siding/wideplating_new/terracotta{
	dir = 6
	},
/turf/open/floor/iron/diagonal,
/area/ruin/unpowered)
"Ay" = (
/turf/closed/wall/mineral/calorite,
/area/ruin/unpowered)
"Bs" = (
/turf/open/lava/smooth/lava_land_surface,
/area/ruin/unpowered)
"Cl" = (
/turf/open/misc/asteroid/basalt/lava_land_surface,
/area/ruin/unpowered)
"CF" = (
/obj/effect/turf_decal/tile/dark_red/diagonal_edge,
/obj/effect/turf_decal/tile/brown/diagonal_centre,
/obj/effect/turf_decal/siding/wideplating_new/terracotta{
	dir = 9
	},
/obj/structure/table/wood/fancy/orange,
/obj/item/slime_cookie/calorite{
	pixel_x = -4;
	pixel_y = -1
	},
/obj/item/slime_cookie/calorite{
	pixel_x = 6;
	pixel_y = 7
	},
/turf/open/floor/iron/diagonal,
/area/ruin/unpowered)
"Db" = (
/obj/effect/turf_decal/tile/dark_red/diagonal_edge,
/obj/effect/turf_decal/tile/brown/diagonal_centre,
/obj/effect/turf_decal/siding/wideplating_new/terracotta{
	dir = 6
	},
/obj/structure/table/wood/fancy/orange,
/obj/item/stack/sheet/mineral/calorite/five,
/turf/open/floor/iron/diagonal,
/area/ruin/unpowered)
"Dc" = (
/obj/effect/turf_decal/tile/dark_red/diagonal_edge,
/obj/effect/turf_decal/tile/brown/diagonal_centre,
/obj/effect/turf_decal/siding/wideplating_new/terracotta{
	dir = 10
	},
/turf/open/floor/iron/diagonal,
/area/ruin/unpowered)
"Dp" = (
/obj/structure/statue/calorite/fatty,
/obj/effect/light_emitter/tendril,
/turf/open/floor/mineral/calorite/dance,
/area/ruin/unpowered)
"DA" = (
/obj/effect/turf_decal/tile/dark_red/diagonal_edge,
/obj/effect/turf_decal/tile/brown/diagonal_centre,
/obj/effect/turf_decal/siding/wideplating_new/terracotta{
	dir = 10
	},
/obj/structure/table/wood/fancy/orange,
/obj/item/slime_cookie/calorite{
	pixel_x = -4;
	pixel_y = -1
	},
/turf/open/floor/iron/diagonal,
/area/ruin/unpowered)
"Fz" = (
/obj/effect/turf_decal/tile/dark_red/diagonal_edge,
/obj/effect/turf_decal/tile/brown/diagonal_centre,
/obj/effect/turf_decal/siding/wideplating_new/terracotta{
	dir = 5
	},
/obj/structure/statue/calorite/pillar,
/turf/open/floor/iron/diagonal,
/area/ruin/unpowered)
"FH" = (
/obj/effect/turf_decal/tile/dark_red/diagonal_edge,
/obj/effect/turf_decal/tile/brown/diagonal_centre,
/obj/effect/turf_decal/siding/wideplating_new/terracotta/corner{
	dir = 4
	},
/obj/structure/trap/fattening,
/turf/open/floor/iron/diagonal,
/area/ruin/unpowered)
"FO" = (
/obj/structure/window/calorite/spawner/directional/east,
/obj/effect/turf_decal/siding/wideplating_new/terracotta{
	dir = 4
	},
/mob/living/simple_animal/hostile/fatten/magehand,
/turf/open/floor/mineral/calorite,
/area/ruin/unpowered)
"FU" = (
/obj/item/paper/fluff/ruins/calorite_facility/shrine_note{
	pixel_x = 10;
	pixel_y = 4
	},
/turf/open/misc/asteroid/basalt/lava_land_surface,
/area/lavaland/surface/outdoors)
"GD" = (
/obj/effect/turf_decal/tile/dark_red/diagonal_edge,
/obj/effect/turf_decal/tile/brown/diagonal_centre,
/obj/effect/turf_decal/siding/wideplating_new/terracotta/corner,
/turf/open/floor/iron/diagonal,
/area/ruin/unpowered)
"GS" = (
/turf/closed/mineral/volcanic/lava_land_surface,
/area/lavaland/surface/outdoors)
"HR" = (
/obj/effect/turf_decal/tile/dark_red/diagonal_edge,
/obj/effect/turf_decal/tile/brown/diagonal_centre,
/obj/effect/turf_decal/siding/wideplating_new/terracotta{
	dir = 10
	},
/obj/structure/table/wood/fancy/orange,
/obj/item/stack/sheet/mineral/calorite/five,
/turf/open/floor/iron/diagonal,
/area/ruin/unpowered)
"Il" = (
/obj/effect/turf_decal/tile/dark_red/diagonal_edge,
/obj/effect/turf_decal/tile/brown/diagonal_centre,
/obj/effect/turf_decal/siding/wideplating_new/terracotta/corner{
	dir = 4
	},
/turf/open/floor/iron/diagonal,
/area/ruin/unpowered)
"IZ" = (
/turf/open/misc/asteroid/basalt/lava_land_surface,
/area/lavaland/surface/outdoors)
"JD" = (
/obj/effect/decal/cleanable/shreds,
/turf/open/misc/asteroid/basalt/lava_land_surface,
/area/lavaland/surface/outdoors)
"JZ" = (
/obj/effect/turf_decal/tile/dark_red/diagonal_edge,
/obj/effect/turf_decal/tile/brown/diagonal_centre,
/obj/effect/turf_decal/siding/wideplating_new/terracotta{
	dir = 10
	},
/obj/structure/trap/belch,
/turf/open/floor/iron/diagonal,
/area/ruin/unpowered)
"Kf" = (
/obj/effect/turf_decal/tile/dark_red/diagonal_edge,
/obj/effect/turf_decal/tile/brown/diagonal_centre,
/obj/effect/turf_decal/siding/wideplating_new/terracotta,
/turf/open/floor/iron/diagonal,
/area/ruin/unpowered)
"Lt" = (
/obj/effect/turf_decal/tile/dark_red/diagonal_edge,
/obj/effect/turf_decal/tile/brown/diagonal_centre,
/obj/effect/turf_decal/siding/wideplating_new/terracotta{
	dir = 9
	},
/obj/structure/table/wood/fancy/orange,
/obj/item/stack/sheet/calorite_glass/five,
/turf/open/floor/iron/diagonal,
/area/ruin/unpowered)
"MK" = (
/obj/effect/turf_decal/tile/dark_red/diagonal_edge,
/obj/effect/turf_decal/tile/brown/diagonal_centre,
/obj/effect/turf_decal/siding/wideplating_new/terracotta/corner,
/obj/effect/light_emitter/tendril,
/turf/open/floor/iron/diagonal,
/area/ruin/unpowered)
"Of" = (
/obj/effect/turf_decal/tile/dark_red/diagonal_edge,
/obj/effect/turf_decal/tile/brown/diagonal_centre,
/obj/effect/turf_decal/siding/wideplating_new/terracotta/corner{
	dir = 8
	},
/turf/open/floor/iron/diagonal,
/area/ruin/unpowered)
"Oh" = (
/obj/effect/turf_decal/tile/dark_red/diagonal_edge,
/obj/effect/turf_decal/tile/brown/diagonal_centre,
/obj/effect/turf_decal/siding/wideplating_new/terracotta{
	dir = 9
	},
/obj/structure/statue/calorite/pillar,
/turf/open/floor/iron/diagonal,
/area/ruin/unpowered)
"Om" = (
/obj/effect/turf_decal/tile/dark_red/diagonal_edge,
/obj/effect/turf_decal/tile/brown/diagonal_centre,
/obj/effect/turf_decal/siding/wideplating_new/terracotta{
	dir = 8
	},
/turf/open/floor/iron/diagonal,
/area/ruin/unpowered)
"Op" = (
/obj/effect/turf_decal/tile/dark_red/diagonal_edge,
/obj/effect/turf_decal/tile/brown/diagonal_centre,
/obj/effect/turf_decal/siding/wideplating_new/terracotta{
	dir = 6
	},
/obj/structure/table/wood/fancy/orange,
/obj/item/stack/sheet/calorite_glass/five,
/turf/open/floor/iron/diagonal,
/area/ruin/unpowered)
"OL" = (
/obj/effect/turf_decal/tile/dark_red/diagonal_edge,
/obj/effect/turf_decal/tile/brown/diagonal_centre,
/obj/effect/turf_decal/siding/wideplating_new/terracotta{
	dir = 4
	},
/obj/structure/trap/fattening,
/turf/open/floor/iron/diagonal,
/area/ruin/unpowered)
"PO" = (
/obj/effect/turf_decal/tile/dark_red/diagonal_edge,
/obj/effect/turf_decal/tile/brown/diagonal_centre,
/obj/effect/turf_decal/siding/wideplating_new/terracotta{
	dir = 5
	},
/obj/structure/trap/belch,
/turf/open/floor/iron/diagonal,
/area/ruin/unpowered)
"Qd" = (
/obj/structure/window/calorite/spawner/directional/south,
/obj/effect/turf_decal/siding/wideplating_new/terracotta,
/mob/living/simple_animal/hostile/fatten/magehand,
/turf/open/floor/mineral/calorite,
/area/ruin/unpowered)
"QM" = (
/obj/effect/turf_decal/tile/dark_red/diagonal_edge,
/obj/effect/turf_decal/tile/brown/diagonal_centre,
/obj/effect/turf_decal/siding/wideplating_new/terracotta{
	dir = 10
	},
/obj/structure/statue/calorite/pillar,
/turf/open/floor/iron/diagonal,
/area/ruin/unpowered)
"QX" = (
/obj/effect/turf_decal/tile/dark_red/diagonal_edge,
/obj/effect/turf_decal/tile/brown/diagonal_centre,
/obj/effect/turf_decal/siding/wideplating_new/terracotta/corner{
	dir = 1
	},
/turf/open/floor/iron/diagonal,
/area/ruin/unpowered)
"TE" = (
/obj/structure/mineral_door/wood,
/obj/structure/barricade/wooden/crude,
/turf/open/misc/asteroid/basalt/lava_land_surface,
/area/ruin/unpowered)
"TR" = (
/obj/effect/turf_decal/tile/dark_red/diagonal_edge,
/obj/effect/turf_decal/tile/brown/diagonal_centre,
/obj/structure/trap/belch,
/turf/open/floor/iron/diagonal,
/area/ruin/unpowered)
"Xv" = (
/obj/effect/turf_decal/tile/dark_red/diagonal_edge,
/obj/effect/turf_decal/tile/brown/diagonal_centre,
/obj/effect/turf_decal/siding/wideplating_new/terracotta{
	dir = 1
	},
/obj/structure/trap/fattening,
/turf/open/floor/iron/diagonal,
/area/ruin/unpowered)
"XN" = (
/obj/effect/turf_decal/tile/dark_red/diagonal_edge,
/obj/effect/turf_decal/tile/brown/diagonal_centre,
/obj/effect/turf_decal/siding/wideplating_new/terracotta/corner{
	dir = 1
	},
/obj/effect/light_emitter/tendril,
/obj/structure/trap/fattening,
/turf/open/floor/iron/diagonal,
/area/ruin/unpowered)
"Yf" = (
/turf/template_noop,
/area/template_noop)

(1,1,1) = {"
Yf
Yf
Yf
Yf
Yf
Yf
Yf
Yf
Yf
Yf
Yf
Yf
Yf
Yf
Yf
Yf
Yf
Yf
Yf
Yf
"}
(2,1,1) = {"
Yf
Yf
Yf
Yf
Yf
Yf
Yf
Yf
Yf
Yf
Yf
Yf
Yf
Yf
Yf
Yf
Yf
Yf
Yf
Yf
"}
(3,1,1) = {"
Yf
Yf
Yf
Yf
Yf
Yf
Yf
Yf
Yf
Yf
Yf
Yf
Yf
Yf
Yf
Yf
Yf
Yf
Yf
Yf
"}
(4,1,1) = {"
Yf
Yf
Yf
GS
GS
GS
GS
GS
GS
GS
GS
GS
GS
GS
GS
GS
Yf
Yf
Yf
Yf
"}
(5,1,1) = {"
Yf
Yf
GS
GS
GS
GS
GS
GS
GS
GS
GS
GS
GS
GS
GS
GS
GS
Yf
Yf
Yf
"}
(6,1,1) = {"
Yf
GS
GS
GS
GS
GS
GS
GS
GS
GS
GS
GS
GS
GS
GS
GS
GS
Yf
Yf
Yf
"}
(7,1,1) = {"
GS
GS
GS
GS
GS
Ay
Ay
Ay
Ay
Ay
Ay
Ay
GS
GS
GS
GS
GS
GS
Yf
Yf
"}
(8,1,1) = {"
GS
GS
GS
Ay
Ay
Ay
ru
Dc
li
ru
Dc
Ay
Ay
Ay
GS
GS
GS
GS
Yf
Yf
"}
(9,1,1) = {"
GS
GS
Ay
Ay
Lt
Om
QX
jQ
li
fz
rn
Om
HR
Ay
Ay
GS
GS
GS
GS
GS
"}
(10,1,1) = {"
GS
GS
Ay
CF
XN
ry
GD
nm
FO
Fz
Il
ry
gm
DA
Ay
GS
GS
GS
GS
GS
"}
(11,1,1) = {"
GS
Ay
Ay
Xv
ry
GD
Ag
Qd
Dp
jI
PO
Il
ry
jQ
Ay
Ay
GS
GS
GS
GS
"}
(12,1,1) = {"
GS
Ay
ru
QX
se
wW
zP
zP
zP
zP
zP
qQ
Il
Of
Dc
Ay
Ay
aw
JD
IZ
"}
(13,1,1) = {"
GS
Ay
vK
hE
nm
FO
zP
Bs
Bs
Bs
zP
FO
Fz
hE
Ag
am
Cl
aw
gt
IZ
"}
(14,1,1) = {"
GS
Ay
li
li
Qd
Dp
zP
Bs
Bs
Bs
zP
Dp
jI
li
li
Ay
Cl
TE
FU
IZ
"}
(15,1,1) = {"
GS
Ay
xX
Om
QM
xl
zP
Bs
Bs
Bs
zP
xl
Oh
Om
JZ
am
Cl
aw
IZ
IZ
"}
(16,1,1) = {"
GS
Ay
vK
Il
Of
Dc
zP
zP
zP
zP
zP
hQ
QX
GD
oV
Ay
Ay
aw
IZ
IZ
"}
(17,1,1) = {"
GS
Ay
Ay
Xv
ry
rn
Dc
Qd
Dp
jI
ru
QX
ry
jQ
Ay
Ay
GS
GS
GS
GS
"}
(18,1,1) = {"
GS
GS
Ay
ft
lv
ry
Of
QM
xl
Oh
QX
TR
MK
Db
Ay
GS
GS
GS
GS
GS
"}
(19,1,1) = {"
GS
GS
Ay
Ay
xQ
OL
FH
Kf
li
Xv
GD
hE
Op
Ay
Ay
GS
GS
GS
GS
GS
"}
(20,1,1) = {"
GS
GS
GS
Ay
Ay
Ay
vK
Ag
li
vK
Ag
Ay
Ay
Ay
GS
GS
GS
GS
Yf
Yf
"}
(21,1,1) = {"
GS
GS
GS
GS
GS
Ay
Ay
Ay
Ay
Ay
Ay
Ay
GS
GS
GS
GS
GS
GS
Yf
Yf
"}
(22,1,1) = {"
Yf
GS
GS
GS
GS
GS
GS
GS
GS
GS
GS
GS
GS
GS
GS
GS
GS
Yf
Yf
Yf
"}
(23,1,1) = {"
Yf
Yf
GS
GS
GS
GS
GS
GS
GS
GS
GS
GS
GS
GS
GS
GS
GS
Yf
Yf
Yf
"}
(24,1,1) = {"
Yf
Yf
Yf
GS
GS
GS
GS
GS
GS
GS
GS
GS
GS
GS
GS
GS
Yf
Yf
Yf
Yf
"}
(25,1,1) = {"
Yf
Yf
Yf
Yf
Yf
Yf
Yf
Yf
Yf
Yf
Yf
Yf
Yf
Yf
Yf
Yf
Yf
Yf
Yf
Yf
"}
(26,1,1) = {"
Yf
Yf
Yf
Yf
Yf
Yf
Yf
Yf
Yf
Yf
Yf
Yf
Yf
Yf
Yf
Yf
Yf
Yf
Yf
Yf
"}
(27,1,1) = {"
Yf
Yf
Yf
Yf
Yf
Yf
Yf
Yf
Yf
Yf
Yf
Yf
Yf
Yf
Yf
Yf
Yf
Yf
Yf
Yf
"}
(28,1,1) = {"
Yf
Yf
Yf
Yf
Yf
Yf
Yf
Yf
Yf
Yf
Yf
Yf
Yf
Yf
Yf
Yf
Yf
Yf
Yf
Yf
"}
(29,1,1) = {"
Yf
Yf
Yf
Yf
Yf
Yf
Yf
Yf
Yf
Yf
Yf
Yf
Yf
Yf
Yf
Yf
Yf
Yf
Yf
Yf
"}
(30,1,1) = {"
Yf
Yf
Yf
Yf
Yf
Yf
Yf
Yf
Yf
Yf
Yf
Yf
Yf
Yf
Yf
Yf
Yf
Yf
Yf
Yf
"}
