//MAP CONVERTED BY dmm2tgm.py THIS HEADER COMMENT PREVENTS RECONVERSION, DO NOT REMOVE
"a" = (
/obj/structure/flora/bush/sparsegrass/style_random,
/turf/open/misc/grass/lavaland,
/area/lavaland/surface/outdoors)
"b" = (
/obj/item/flashlight/lantern/on{
	pixel_x = 11;
	pixel_y = 0
	},
/obj/structure/flora/bush/sparsegrass/style_random,
/turf/open/misc/grass/lavaland,
/area/lavaland/surface/outdoors)
"c" = (
/obj/item/storage/box/milking_kit,
/obj/structure/closet/crate/wooden,
/obj/item/reagent_containers/cup/bottle/succubus_milk{
	pixel_x = -5;
	pixel_y = -1
	},
/turf/open/floor/wood/large,
/area/ruin/unpowered)
"d" = (
/obj/structure/decorative/shelf/milk,
/turf/open/floor/wood,
/area/ruin/unpowered)
"e" = (
/obj/structure/railing/wooden_fence{
	dir = 6
	},
/obj/structure/flora/bush/grassy/style_random,
/turf/open/misc/grass/lavaland,
/area/lavaland/surface/outdoors)
"f" = (
/turf/closed/wall/mineral/wood,
/area/ruin/unpowered)
"g" = (
/obj/structure/chair/milking_machine,
/turf/open/floor/hay,
/area/ruin/unpowered)
"h" = (
/obj/structure/closet/crate/wooden,
/obj/item/reagent_containers/condiment/milk,
/obj/item/reagent_containers/condiment/milk,
/obj/item/reagent_containers/condiment/milk,
/obj/item/reagent_containers/cup/jerrycan/milk,
/obj/item/reagent_containers/cup/jerrycan/milk,
/turf/open/floor/wood/large,
/area/ruin/unpowered)
"i" = (
/obj/item/flashlight/lantern/on{
	pixel_x = -12;
	pixel_y = 0
	},
/obj/effect/turf_decal/siding/wood{
	dir = 8
	},
/turf/open/floor/wood/large,
/area/ruin/unpowered)
"j" = (
/obj/structure/railing/corner/end/wooden_fence,
/obj/structure/flora/bush/sparsegrass/style_random,
/turf/open/misc/grass/lavaland,
/area/lavaland/surface/outdoors)
"k" = (
/obj/structure/flora/bush/lavendergrass/style_random,
/turf/open/misc/grass/lavaland,
/area/lavaland/surface/outdoors)
"l" = (
/obj/structure/railing/wooden_fence{
	dir = 10
	},
/obj/structure/flora/bush/grassy/style_random,
/turf/open/misc/grass/lavaland,
/area/lavaland/surface/outdoors)
"m" = (
/obj/structure/railing/corner/end/wooden_fence,
/obj/structure/railing/corner/end/flip/wooden_fence,
/obj/effect/turf_decal/siding/wood,
/turf/open/floor/hay,
/area/ruin/unpowered)
"n" = (
/obj/effect/turf_decal/siding/wood{
	dir = 4
	},
/turf/open/floor/wood/large,
/area/ruin/unpowered)
"o" = (
/turf/open/misc/grass/lavaland,
/area/lavaland/surface/outdoors)
"p" = (
/obj/structure/railing/wooden_fence,
/obj/structure/flora/bush/sparsegrass/style_random,
/turf/open/misc/grass/lavaland,
/area/lavaland/surface/outdoors)
"q" = (
/obj/structure/reagent_dispensers/cooking_oil/cream/open,
/turf/open/floor/hay,
/area/ruin/unpowered)
"r" = (
/obj/structure/reagent_dispensers/servingdish{
	name = "nutrislop dish";
	desc = "Syndicate's finest, sloppest."
	},
/turf/open/floor/wood/large,
/area/ruin/unpowered)
"s" = (
/obj/structure/decorative/shelf/crates,
/obj/effect/turf_decal/siding/wood,
/turf/open/floor/wood,
/area/ruin/unpowered)
"t" = (
/obj/effect/turf_decal/siding/wood{
	dir = 8
	},
/turf/open/floor/wood/large,
/area/ruin/unpowered)
"u" = (
/obj/item/clothing/neck/human_petcollar/locked/cow,
/turf/open/floor/hay,
/area/ruin/unpowered)
"v" = (
/obj/structure/railing/wooden_fence{
	dir = 8
	},
/obj/structure/flora/bush/grassy/style_random,
/turf/open/misc/grass/lavaland,
/area/lavaland/surface/outdoors)
"w" = (
/obj/structure/railing/wooden_fence{
	dir = 4
	},
/obj/structure/flora/bush/lavendergrass/style_random,
/turf/open/misc/grass/lavaland,
/area/lavaland/surface/outdoors)
"x" = (
/obj/structure/decorative/shelf,
/obj/item/reagent_containers/cup/bottle/succubus_milk{
	pixel_x = -5;
	pixel_y = -1
	},
/obj/item/reagent_containers/cup/bottle/succubus_milk{
	pixel_x = 7;
	pixel_y = -1
	},
/obj/effect/turf_decal/siding/wood{
	dir = 6
	},
/turf/open/floor/wood,
/area/ruin/unpowered)
"y" = (
/turf/open/floor/hay,
/area/ruin/unpowered)
"z" = (
/obj/structure/flora/bush/grassy/style_random,
/obj/structure/flora/bush/lavendergrass/style_random,
/turf/open/misc/grass/lavaland,
/area/lavaland/surface/outdoors)
"A" = (
/obj/structure/railing/corner/end/flip/wooden_fence,
/turf/open/misc/grass/lavaland,
/area/lavaland/surface/outdoors)
"B" = (
/obj/structure/decorative/shelf,
/obj/effect/turf_decal/siding/wood{
	dir = 10
	},
/obj/item/reagent_containers/cup/jerrycan/milk{
	pixel_x = -3;
	pixel_y = -3
	},
/obj/item/reagent_containers/cup/jerrycan/milk{
	pixel_x = 3;
	pixel_y = -3
	},
/turf/open/floor/wood,
/area/ruin/unpowered)
"C" = (
/obj/structure/railing/wooden_fence,
/obj/structure/flora/bush/grassy/style_random,
/turf/open/misc/grass/lavaland,
/area/lavaland/surface/outdoors)
"D" = (
/obj/structure/reagent_dispensers/plumbed,
/turf/open/floor/wood/large,
/area/ruin/unpowered)
"E" = (
/obj/structure/ore_container/food_trough/gutlunch_trough,
/turf/open/floor/wood/large,
/area/ruin/unpowered)
"F" = (
/obj/structure/chair/wood,
/obj/item/clothing/head/cowboy/white{
	pixel_x = -1;
	pixel_y = 0
	},
/turf/open/misc/grass/lavaland,
/area/lavaland/surface/outdoors)
"G" = (
/obj/structure/railing/wooden_fence,
/obj/structure/ore_container/food_trough/raptor_trough,
/obj/item/food/grown/grass{
	pixel_x = -5;
	pixel_y = 6
	},
/obj/item/food/grown/grass{
	pixel_x = 2;
	pixel_y = 8
	},
/obj/item/food/grown/grass{
	pixel_x = 4;
	pixel_y = 0
	},
/obj/effect/turf_decal/siding/wood,
/turf/open/floor/hay,
/area/ruin/unpowered)
"H" = (
/obj/structure/reagent_dispensers/cooking_oil/cream,
/turf/open/floor/hay,
/area/ruin/unpowered)
"I" = (
/obj/structure/decorative/shelf/milkjugs,
/turf/open/floor/wood,
/area/ruin/unpowered)
"J" = (
/obj/structure/closet/crate/large,
/turf/open/floor/wood/large,
/area/ruin/unpowered)
"K" = (
/obj/structure/fans/tiny/invisible,
/obj/structure/mineral_door/wood,
/obj/effect/turf_decal/siding/wood,
/obj/effect/turf_decal/siding/wood{
	dir = 1
	},
/turf/open/floor/wood,
/area/ruin/unpowered)
"L" = (
/obj/item/melee/baton/security/cattleprod{
	pixel_x = 11;
	pixel_y = 0
	},
/obj/item/flashlight/lantern/on{
	pixel_x = -12;
	pixel_y = 0
	},
/turf/open/misc/grass/lavaland,
/area/lavaland/surface/outdoors)
"M" = (
/turf/closed/mineral/volcanic/lava_land_surface,
/area/lavaland/surface/outdoors)
"N" = (
/obj/structure/railing/wooden_fence,
/obj/structure/ore_container/food_trough/raptor_trough,
/obj/item/food/grown/grass{
	pixel_x = -5;
	pixel_y = 6
	},
/obj/item/food/grown/grass{
	pixel_x = -1;
	pixel_y = 8
	},
/obj/item/food/grown/grass{
	pixel_x = 3;
	pixel_y = 2
	},
/obj/effect/turf_decal/siding/wood,
/turf/open/floor/hay,
/area/ruin/unpowered)
"O" = (
/turf/open/floor/wood/large,
/area/ruin/unpowered)
"P" = (
/obj/structure/railing/wooden_fence,
/obj/structure/flora/bush/lavendergrass/style_random,
/turf/open/misc/grass/lavaland,
/area/lavaland/surface/outdoors)
"Q" = (
/obj/machinery/iv_drip/feeding_tube,
/turf/open/floor/hay,
/area/ruin/unpowered)
"R" = (
/obj/structure/railing/wooden_fence,
/turf/open/misc/grass/lavaland,
/area/lavaland/surface/outdoors)
"S" = (
/obj/item/flashlight/lantern/on{
	pixel_x = 11;
	pixel_y = 0
	},
/obj/effect/turf_decal/siding/wood{
	dir = 4
	},
/turf/open/floor/wood/large,
/area/ruin/unpowered)
"T" = (
/obj/structure/closet/crate/wooden/storage_barrel,
/turf/open/floor/wood/large,
/area/ruin/unpowered)
"U" = (
/obj/structure/flora/bush/grassy/style_random,
/turf/open/misc/grass/lavaland,
/area/lavaland/surface/outdoors)
"V" = (
/obj/structure/railing/wooden_fence{
	dir = 4
	},
/obj/structure/railing/wooden_fence{
	dir = 8
	},
/obj/effect/turf_decal/siding/wood{
	dir = 8
	},
/obj/effect/turf_decal/siding/wood{
	dir = 4
	},
/turf/open/floor/wood,
/area/ruin/unpowered)
"W" = (
/turf/template_noop,
/area/template_noop)
"X" = (
/obj/structure/railing/wooden_fence{
	dir = 4
	},
/obj/structure/railing/wooden_fence{
	dir = 8
	},
/obj/item/flashlight/lantern/on{
	pixel_x = 0;
	pixel_y = -16
	},
/obj/effect/turf_decal/siding/wood{
	dir = 8
	},
/obj/effect/turf_decal/siding/wood{
	dir = 4
	},
/turf/open/floor/wood,
/area/ruin/unpowered)
"Y" = (
/obj/structure/decorative/shelf/milk_big,
/turf/open/floor/wood,
/area/ruin/unpowered)
"Z" = (
/obj/structure/railing/wooden_fence,
/obj/structure/reagent_dispensers/servingdish{
	name = "nutrislop dish";
	desc = "Syndicate's finest, sloppest."
	},
/obj/effect/turf_decal/siding/wood,
/turf/open/floor/hay,
/area/ruin/unpowered)

(1,1,1) = {"
W
W
W
W
W
W
W
W
W
W
W
W
W
W
W
W
W
W
W
W
"}
(2,1,1) = {"
M
M
M
M
M
W
W
M
M
M
M
W
W
W
W
W
W
W
W
W
"}
(3,1,1) = {"
M
f
f
M
M
M
M
M
f
f
M
M
M
W
W
f
f
v
l
W
"}
(4,1,1) = {"
M
f
f
f
f
f
f
f
f
f
f
f
f
f
f
f
f
k
p
W
"}
(5,1,1) = {"
M
M
f
q
y
y
Z
O
O
J
h
c
O
J
T
f
L
U
P
W
"}
(6,1,1) = {"
W
M
f
y
g
u
m
O
O
S
n
n
S
O
O
f
F
z
p
W
"}
(7,1,1) = {"
W
M
f
Q
y
y
G
B
O
f
Y
I
f
O
O
K
a
o
j
W
"}
(8,1,1) = {"
W
M
f
f
X
V
f
s
O
f
f
f
f
O
O
K
o
o
o
W
"}
(9,1,1) = {"
W
M
f
Q
y
y
N
x
O
f
Y
d
f
O
O
K
o
a
A
W
"}
(10,1,1) = {"
W
M
f
H
g
u
m
O
O
i
t
t
i
O
O
f
U
k
C
W
"}
(11,1,1) = {"
M
M
f
y
y
y
Z
O
O
O
D
r
O
E
E
f
b
U
P
W
"}
(12,1,1) = {"
M
f
f
f
f
f
f
f
f
f
f
f
f
f
f
f
f
a
R
W
"}
(13,1,1) = {"
M
f
f
M
M
M
M
M
f
f
M
M
M
M
W
f
f
w
e
W
"}
(14,1,1) = {"
M
M
M
M
M
M
M
M
M
M
M
M
M
W
W
W
W
W
W
W
"}
(15,1,1) = {"
W
M
M
W
W
W
W
M
M
M
M
W
W
W
W
W
W
W
W
W
"}
